склеивание: склеиванием
упрощать: упрощает
потомок: потомком потомка потомками потомок потомков потомку
сила: сил силами Сила силы силах силу
градус_цельсия: Градус_Цельсия
считать: считать считаете считали Считать Считающие
транслятор: транслятор
дженга: Дженга
слой: слоев слой
обстоятельство: обстоятельствах обстоятельств
бессмыслица: Бессмыслица
папка: папку папке папка папкой папки
парсинга: парсинга
заставить: заставит заставят заставить
другой: другую другому Другое другие другими Другим другое другим другая другого Другой других Другие
массив: массив Массив массива массивом массивов массиву массиве
размещать: размещаемыми размещать размещают
закрасться: закралось
сумма: сумму сумма Сумма сумме суммы суммами
новый: Новый новых Новые новые новый нового новую новой новая Новая новом
предыдущий: предыдущих предыдущие предыдущий предыдущем предыдущую предыдущими Предыдущие
вспоминать: вспоминал
понимать: понимаете понимает понимают понимаю понимать понимаешь
сам: самих Сами саму сами сама Сам само
название: названию названием названия Названия названиями название названиям названий
очень: ОЧЕНЬ очень Очень
безопасный: безопасен безопасным безопасная Безопасная безопасны
потратить: потратите потратил потрачено
откуда: Откуда откуда
плюсовать: плюсую
параметр: параметрами параметр параметром параметров параметра параметрах параметры
вы: вами Вас Вам Вы
архивный: Архивная
напомнить: напомню Напомню
переуступить: переуступить
макрос: макросов
вновь: Вновь вновь
выкидывать: выкидывает
игорь: Игорь
шум: шумов шума
год: годом год году лет годы года
роберт: Роберт Робертом
месяц: месяца месяцы месяц
подключить: подключит подключить подключенном подключили Подключить
исключение: исключений Исключение исключение исключением
получиться: получится получился получиться Получилось получившиеся получилось
возраст: возрасту возраст возрасте
тестировать: тестировать тестируем Тестируем
отказ: отказ отказа Отказ
готовый: готовый Готовы готовая готовым готов Готово готовыми готовую готовые готово
редактирование: редактировании редактирования
приглашать: Приглашаем приглашать приглашает
оставлять: оставляет оставляем оставлять
наличие: наличие наличия наличии
увеличение: увеличения увеличением
оценить: оценим оценить оценив
анализироваться: анализируются
константа: константу константой констант
научный: научный научного научной
оставить: Оставить оставив оставить оставит
интеллектуальный: Интеллектуальные интеллектуальной интеллектуальным интеллектуальных интеллектуальные
проект: проектами проекту Проект проекты проекте проект проектов проектом проекта проектах
близко: близко
раскрывать: раскрываемые раскрывать
гигант: Гигант
общий: общем общего общих Общие общей общее общему общую общий общие Общий Общую Общее Общая общая
подкаталог: подкаталог
переопределение: Переопределение
читать: Читая Читай читающий читает Читать читаю читали читать читайте читаешь
поле: полем полями поля полей
сообщество: сообщества сообществом Сообщество сообществах сообщество
равенство: равенству равенством равенство равенства
жизнь: жизнь Жизни жизни жизнью
вызвать: вызвать вызвав вызвали вызвала вызван Вызвав
дата: дату даты дата Дата
неоднократно: неоднократно
старенький: старенький
поймать: поймать
пост: Посты посте посты постах
начать: начнёт Начнем Начать начал начали Начнём начать начнет начнём
тройка: тройку
константный: константный константное
ребята: ребята Ребята ребят
отряд: отряд отряда отряду Отряд
превратиться: превратились превратилось
хватать: хватает хватаем хватать хватало
материал: Материалы Материал материалы материалов материале Материалов материал материала
магия: Магия магия
прекрасный: прекрасный прекрасна прекрасного
идти: идут идущие Шел идет идем Идем Идешь идущих Иду идти идёт
просьба: просьба
какой: каком какую какие Какое какими какое каким каких какого какому Какая Какие
систематизация: систематизация
предпочтительный: предпочтителен
помогать: помогает помогаю помогаем Помогает помогают Помогаем
формироваться: формироваться формируется
участник: участниками участников участником
ширина: ширина Ширина ширину
наука: науках наук Наука
оценщик: Оценщик
подписчик: подписчик подписчика подписчиков Подписчики
попытаться: попытаемся
окно: окне Окно окна окно
жёсткий: жесткого
точный: точных точными точная точному
предоставить: предоставим предоставил предоставленные предоставленная предоставленную предоставить предоставлено предоставив
предложение: предложение
модуль: модулей модуль модуля модули
лектор: лектора
основатель: основатель
процессовва: процессовВ
бизнес: бизнес бизнесов бизнеса Бизнес
одновременный: одновременным
непонятный: непонятных
персональный: Персональные персональные Персональную персональным персональных Персональная персональный
ненужный: ненужного ненужный
стриминговый: Стриминговый стриминговое
альтернативный: альтернативных альтернативную альтернативное
нарушить: нарушит нарушить
рабочий: рабочие рабочего рабочей
саратов: Саратов
пузанок: Пузанков
обычный: обычных обычную обычная Обычный обычный
картинка: картинках картинке картинку
издержка: издержек
учебник: учебником Учебники учебнике учебник
получить: Получить получив Полученные полученные полученный получите получена полученных Получим полученном получим Полученный полученного полученное получили получить получены получил
миграция: миграции Миграции миграций миграцию Миграция
звезда: Звёзды
одинаковый: одинаковы одинаковый одинакового одинаковым одинаковое одинаковые одинакова одинаковыми одинаковых
воспроизвести: воспроизведет воспроизвести воспроизведенному
потребление: потребления потребление
реальность: реальности реальность
тариф: Тариф
прошлый: прошлом прошлых прошлой
идентификация: идентификации Идентификация идентификацию
надёжный: надежными
нахождение: нахождении нахождению нахождения
корпус: корпуса
остальной: остальные Остальные остальное остальными остальных
жидкий: жидкого
содержаться: содержащаяся содержатся содержащиеся содержаться содержится
сборник: сборником
сохранность: сохранность
этот: этими Эта Эти Эту этих эта Этот
будущий: будущей
нужный: нужный нужной нужную нужное Нужна нужным нужен нужные Нужны нужна нужны нужном нужного
провалить: провален
встреча: встреча встреч встречи
импорт: импорт
система: системах системой Систему систем системе системам систему системы Системы система Система
зачаток: Зачатки
пригласить: Пригласила Пригласил Приглашен
физик: физик физиком
переписать: переписать
токен: токен
разметить: разметить
трогать: трогаем трогать
слева: слева Слева
температурный: температурной температурную Температурные
запрещаться: Запрещается
умный: умная умных Умный Умные
плохой: хуже худшем плохие плохая худшую Плохая
михаил: Михаил
срок: сроках срок
юридический: юридической юридического
свободный: свободной свободными Свободная свободный свободного Свободный Свободным свободные
микросервисный: Микросервисная микросервисных
участвовать: участвует участвовала Участвовать участвуют участвующие участвовать
нативный: нативную нативные нативными нативном
интеллект: интеллект интеллекта интеллектом
интех: Интех интех
образ: Образы образом образов образу образа образ образы
принять: приняли примет принять принято принята
любой: любого Любое любые любое любыми любых любую любая любом Любые
распространить: распространенные распространённым распространённая распространённый распространён распространенных
хеширование: хеширования
рекламный: рекламную рекламных Рекламная рекламными
композиция: композиции
формат: формат форматов формата Форматы форматом формате форматах
отступление: отступления отступление
путешествие: Путешествие
средство: средство средствами средств
обнаружить: Обнаружены обнаружит обнаружим обнаружил
использовать: используемому Используйте используют использовал используя использовать использующие использовали использую использующий используете используйте Используя используемой использованы используемый используемых использован Использовать Используемый использовав используемого использует
сверху: Сверху сверху
создать: созданы создали созданных Создай создадим Создан созданные Создайте созданном создан создаст создала созданными Создать Создадим создать
ведро: ведром ведра
серия: серии серию серий серия
монета: монету монет монетой монетам монеты монетами монетах Монеты монете монета
удобный: удобнее удобных удобной удобным удобны удобном удобный
корпорация: корпорация
форматирование: форматирования Форматирование
контур: Контур
профиль: Профиль Профиля профиль Профиле Профилем профиля Профилей профилем профили профиле профилей
ладья: Ладья
размер: размер Размер размера размеров размером размерах
получать: получаем получаю Получаем Получай получающая получаемое Получать получать получаемой получает получают получая Получайте
город: город городе городом города городов
базис: базис Базис
падать: падало
использование: использования использованию Использование использовании использование использованием
наш: нашу Наша нашем наше Наши Наш Наше наших нашего нашей нашим наш нашему наша наши
звучать: Звучит звучит
специалист: специалисты Специалист специалистами специалисту Специалисты специалистов Специалистам специалиста специалист
величина: величину величин величина величиной величины
пользователь: Пользователе пользователя Пользователя пользователем Пользователям Пользователями Пользователем Пользователи пользователей Пользователь пользователях пользователи пользователь Пользователю Пользователей пользователями
самосовершенствование: самосовершенствования
услуга: услугу Услуги услуг услуги
пройти: прошли пройдет прошло прошел Пройти пройдем пройденного пройти
билет: билеты билет билета билетов
упоминание: упоминание
оптимизация: Оптимизация оптимизация оптимизации оптимизацию
таблица: таблица таблицей таблице таблицы таблицу таблицами Таблицы
камера: камере камера камеру Камера
политика: политика Политика Политике политику политики Политикой Политику Политики политике
надо: Надо
предпочтение: предпочтениях
алгоритм: алгоритмы алгоритмом алгоритмов алгоритм алгоритма алгоритмам алгоритме алгоритмах Алгоритмы алгоритму Алгоритм
согласие: согласий согласия согласие
работа: работу работе работ работа Работа работы работами
социальный: Социальный социальные социальному социальных социальной
атмосферный: атмосферного
заказать: заказать
рассказать: расскажите рассказать расскажут рассказали расскажу расскажем рассказал расскажи
сетевой: сетевыми Сетевые сетевого
строка: строку строк Строки строках строка строке строки
блок: блоке блок Блока блоков блоками блока Блок
обидно: Обидно
вылететь: вылетела вылетело
закачка: закачка
менеджмент: менеджмент менеджмента менеджментом Менеджмент
анкета: анкет
узел: узлами узла узлы узел узлах узлов
малый: наименьшую наименьшее наименьший меньшие меньшую меньшего
генярться: геняртся
выступить: выступить выступили
росбанк: Росбанк
технически: Технически
меняться: меняться меняются менялась менялся меняется
комментарий: Комментарий комментарий комментарием комментария комментариях комментариев
естественный: естественны естественных естественным естественном естественный
товар: товаров товарах товара товары товарам товаре товар
всякий: всякие всякого
взрывчатый: взрывчатых
иерархия: иерархия иерархию иерархией
учитывать: учитывали учитываем учитывая Учитывая учитывать учитываете учитывают
вить: Вью
концепция: концепций Концепция концепции
храниться: храниться хранятся хранится хранились хранящимися
реверс: реверс Реверс
абсолютный: Абсолютный
вернуться: вернуться вернется Вернемся
спасти: спасут
адаптер: Адаптер
лишний: лишних лишние лишнее
подробный: поподробнее Подробное подробным подробное подробнее Подробнее
заголовок: заголовок заголовком заголовки
последующий: Последующее последующем последующих последующее
продвинуть: Продвинутый продвинутым продвинутых
медицинский: медицинские
описываться: описывается описываются
внимательно: внимательно
последний: последнее последнего последних Последние последнем Последнюю Последняя последние последний Последним последней
пакет: пакетами пакета пакетом пакет пакетов пакетам пакете
редактор: Редактор редактором редакторе редактора редактор редакторы
дух: духе
достигаемый: достигаем
билд: билда
понятие: понятии понятий понятие понятия понятием понятиях
дополнять: Дополняем
ижевск: Ижевск
общение: общения
произойти: произойти произойдёт произошла произошло произошел произошедшие
свой: своими свое своих Своя Свои своё своего свои своем своему своём свой
операция: операциями операция операцию операций операцией
случайный: случайных случайного случайный Случайная случайным случайное
следовать: следует следуя
тренд: тренды трендах трендов
дть: демо
стартап: стартапе стартап
выразить: выразил
регламент: Регламент регламентами
байт: байты байта байт байте
клиент: клиента клиентом клиенте клиентам Клиент клиент клиентами клиентов клиенту
служба: Службы служб службу службы Служба
карма: Карма кармы карму
выход: выходу выхода выходе выход Выход
повестка: повесток
заведомо: заведомо
карпов: Карпов
лог: логи лог логе логов логу
дайджест: дайджесты Дайджест
хороший: получше лучшая Хороший лучший лучших лучшими хорошие лучшем хорошая хороший лучшие лучшего наилучшую хорошую Лучший хорошему Лучше Хорошая Лучшие хороши Лучшее
образование: образование образования Образование
джет: Джет
проектирование: проектирования проектировании Проектирование
метод: методу методе методов методам метода Методу методом Методы Метод метод методы методах
хитрый: хитрое хитрые похитрее
полный: полное полную полным полный полна полного полных Полный полном полная
косвенный: косвенным
курс: Курс Курсы курсов курсе курсы курса КУРС курс
документ: Документы документах документе документ документа документами документов документы документам
допускать: допускаемых
крупный: крупнейшее крупного Крупнейшие крупнейших крупнейшая Крупнейший крупных
направить: направлены направленный направленные направленных Направленные направленным
утилита: утилитой утилита
заполнить: заполнить заполнен заполнил заполненными заполненный заполненных Заполните
первый: Первые первых Первая первый первом Первым первым первая Первый первого первой первые первую
терпеть: терпит
зависимость: зависимостей зависимость зависимости зависимостями
поехать: поехавшие
ведение: ведению ведения Ведение
суперавтомат: суперавтоматы
игра: Игр играх игра Игры игры играм игре игру игр
составить: составить составят составлены составлено составит
небольшой: небольшое небольшую Небольшая
возможный: возможны возможную Возможны возможна возможных возможным возможные
тишина: тишины
каталог: каталог каталоги каталоге Каталог
юниор: юниор
письмо: письмом письме письмо
поиск: Поиск поиск Поиском поиску поиском поиска поисках поиске
приводить: приводить привожу приводит
запись: запись Запись записей
личность: личности личность
продажный: Продажная
послушать: послушать послушай
учиться: учится учиться
нарушение: нарушение нарушением нарушений нарушения Нарушение нарушениями нарушении
несложный: несложное несложная
операционка: операционки
включить: включить включил Включить
провести: провести провели проведём Проведём
запускать: Запускать запускать Запускаем запускаем запускает
иметь: имел имеют имеющим имеющих имеем иметь имеющее имеющими имеющую имеющий имеет имея имеете имеющая Имеет
реализовывать: реализовывать
построить: построенное построивших построили Постройте построена построить
три: трех трёх Три тремя
мы: Нам нами нам Мы
быстро: быстро
равный: равна равных равное равны равен равными равным равного равные
склеить: склеена склеив склеить
обрабатываться: обрабатывается обрабатывались
ознакомиться: Ознакомились ознакомиться
эффект: эффектами эффекта эффектов
моделирование: моделирование
неавторитетный: неавторитетный Неавторитетный неавторитетном
бинарный: бинарные бинарный бинарных Бинарное Бинарные бинарное
голландский: голландский
вид: вид виде вида виду виды видом Виды видов
удалить: удалит удалить Удалите удалил удалена удалила
установка: Установка установка установку установки установке установкой установок
привлечение: привлечением привлечения
железяка: железяку
заливать: заливает заливаем
кинуть: кинули
человек: человеку человек люди Человек людей человеком людьми человека
делить: делило деленному делить
попытка: попытку попытки попытке попытка попыток
добавление: добавлении добавление Добавление добавления добавлением
дизайнер: дизайнеров дизайнер дизайнера Дизайнер дизайнером
дело: дело деле дела Дело
индекс: индексов индекс индексом индексами индекса индексы индексу
авторство: авторства авторстве
разобраться: Разобравшись разберемся разобраться
иметься: Имеется имеющихся имеющиеся имеются Имеются имеется
войти: Войти войти Войдите войдите
прикрепить: прикреплен прикрепите
кросс: кросс
позволять: позволяющая позволяет позволяли позволяют позволяющее позволяя позволяющим позволяющий
начинать: начиная начинаю начинают начинает Начиная начинаете начинаем начинать Начинали начинала
умение: умение
онбординг: онбординга
день: День день дни дней Днём дня
платформа: платформы платформа платформ платформе Платформы платформу Платформа
мегабайт: мегабайта
отобразить: отображена
хотеть: хочет хотим хотите хотели хочу хотел Хочу Хотите Хотели хочешь
число: числом число числа числе Число числам числами числу чисел
предоставление: предоставление предоставления предоставлению предоставлением
диагональный: диагональные Диагональная
захватить: захватить
пофиксить: пофиксить
статус: статуса статус
леваяграница: леваяГраница
сложный: сложного сложный сложных сложные Сложный сложнее сложная сложны сложную сложном сложней посложнее
черта: черту черта
доклад: Доклады доклад Доклад доклады доклада докладе докладов
брать: беру Берем берет брать берем
ява: явы яве
говорить: говорить говорят говоря говорит говорите говорю Говорят Говорим
криптопроект: криптопроектах
диапазон: диапазону диапазоне диапазона
вычитать: вычитать
параллельный: параллельный Параллельная Параллельного параллельному параллельного
итератор: итератор итератором итератора итераторов итераторам Итератор
бесплатный: Бесплатный бесплатные бесплатного бесплатный бесплатном бесплатных бесплатное бесплатной Бесплатные
перенос: переноса переносу перенос переносов
самоцель: самоцель
разрабатываться: разрабатываются разрабатывались
объектный: Объектно объектно Объектный
средний: Средняя средняя средней Средний средних
символ: символа символов символы символу символами символ
отредактировать: отредактировать отредактирована
пиксмуть: ПИКСМУВ
команда: Команда команды команде командах команда командой команд команду
среда: среда среде среды сред
верстальщик: верстальщиком верстальщик Верстальщик
дерево: дереве дерева деревьев деревья деревом дерево дереву деревьях
матрица: матриц матрицы матрица Матрицы матрицу
уточнение: уточнение
письменный: письменного письменное письменной
стать: Стать статей стал стало стать станет стали стала
ильф: Ильфом
непосредственно: непосредственно
псков: Псков
контент: Контентом контентом контенту Контента Контенту контента Контент контент
играть: играть
стиль: стиле стиля стилю стили
лицензионный: Лицензионное
кельвин: кельвина кельвину кельвин кельвином Кельвин Кельвина Кельвины кельвинах
викисклад: Викискладе
сертификат: сертификатом сертификаты Сертификат сертификата сертификатов сертификатами сертификат
мониторить: мониторить
лист: листов листьев листа листьями
соседний: соседним соседних соседние соседними
помощь: помощь Помощь помощью
порядок: порядка порядок порядку Порядок порядке
руководитель: руководителем руководителей Руководитель
коммуникация: коммуникации коммуникаций коммуникациях
некий: некоего некий
маршрутизация: Маршрутизация
аккуратно: аккуратно
чат: Чаты чатов чата чат
международный: международных Международной Международный Международная международного международные Международным
профессия: профессий Профессия профессиям Профессий
шабалин: Шабалин
отчёт: отчеты отчёт отчете отчет отчёту отчету отчета
официальный: Официальные официальные официальное официальную
экстремум: экстремума
остаться: остались остался останется оставшееся Осталось осталось оставшиеся Остался осталась
декабрь: декабря декабре
сдача: сдачи Сдача
рейтинг: рейтингами рейтинг рейтингом Рейтинги Рейтинг рейтинге рейтинги рейтинга рейтингу
ташкент: Ташкент
далёкий: далеком дальше Дальше
знак: знаки знаком знак знаков знака
весь: вся всему Всего весь всем Весь Вся Всем всеми
разбираться: разбирается разбираетесь разбираются разбираемся разбираться Разбираемся
велосипед: велосипед
прочитать: прочитает прочитать Прочитать прочитают прочитаете
заменять: заменяющий Заменяем
словарь: Словари словарь Словарь
наркоман: наркоман наркомана
связать: связана связан связаны связано связанная связать
переименование: переименование переименования Переименование
вызываться: вызывается
сбой: сбоя
дополнение: дополнениями дополнение
головоломка: головоломку головоломки
рагозин: Рагозин
точка: точка точке точках точек точку точками точкам Точка точки
замечание: замечание Замечания Замечание замечания
оценочный: оценочную Оценочный
шмидт: Шмидта
переполнение: переполнению переполнения
некорректно: некорректно
указатель: указателю указателей указатель указателя указатели указателями указателях
немного: Немного немного
найти: найден найдем найдет Найден найти Нашедший найденных Найдём нашел найденное найдено найдём Найдите Найди нашёл найденную Найти
стас: Стас
напрямую: напрямую
объединить: объединить
копия: копий копия
планировщик: планировщики Планировщик
интересный: Интересные интересной интересную интересный интересная интересное интересного интересных интереснее интересном интересны интересные
учёба: Учеб учеб
наугад: наугад
линнея: Линнея
узнавать: узнаю узнаём
ребёнок: ребёнка ребенка ребенке детям Дети детей
надёжность: надежностью надежность Надежность надежности
выяснять: выясняло
баг: баг багами багов Баг
витрина: витрины витрин
прийти: придёт придешь пришедшее Пришло пришла пришло пришел
мозг: мозг мозги
пояснить: пояснить поясните пояснил поясню
лёгкий: Легче легких легче Легкий
кнопка: кнопки кнопку Кнопки Кнопка
достаточно: Достаточно достаточно
блокчейн: Блокчейн блокчейне блокчейна
проверяться: проверяются проверялась
алгебра: алгеброй алгебре Алгебра алгебра
методика: Методика методики
надзорный: надзорному
производственный: производственных
легко: легко
болгенос: Болгеносом
большой: большое Больше большому побольше
простота: простоту простота Простота простоты
расписать: расписано Распиши
установиться: установится установятся
толкование: толкованием толкование
тестирование: тестировании тестированием тестирования тестированию тестирование Тестирование
дифференциальный: дифференциальными дифференциальных
направление: направления направлении направлений направлению направлением направление
путать: путать
обзорный: Обзорная
монгол: Монгол
сектор: сектора сектор
габарит: Габариты габариты
придирка: Придирка
инструмент: инструментов инструментом инструменты инструментам инструмента Инструменты инструментах инструмент
старый: старые старых старый старая старым старой старом
разбить: разобьём разбить
аксиома: аксиомам аксиоме
финансовый: финансовых Финансовое финансовой финансовый Финансовый финансовые
госконтора: Госконтора
индикатор: Индикаторы индикатор индикаторы
применять: применяемая Применяем применяют применять применяя
ходить: Ходим ходят
отзыв: отзыва отзыв
работать: Работать работают работали Работаем работать работающий работает работало работаю работающие работающих Работает работал работаем
соглашение: Соглашением Соглашению Соглашении Соглашений соглашения соглашению соглашение Соглашение Соглашения
писать: писать пишите Пишу пишут пишет пишем писал пишу Пишем писали
заключить: заключенным заключенный заключенных заключить
переход: перехода переход
сервис: сервисом сервисы Сервису сервис Сервис сервисов Сервисы сервиса сервисе Сервиса Сервисе
элементарный: элементарным элементарном Элементарные элементарных
анатолий: Анатолий
путь: Путь путями путь
полно: полно
склад: складах складе склад складом
пространство: Пространства пространство пространством пространстве пространства Пространство пространствами пространств
владение: владение
программировать: программируем программировать программирует
утопия: утопия
максим: Максим
атака: атакой атак Атака атаках атаки атаке
просмотр: просмотров просмотр Просмотры просмотре Просмотр Просмотров просмотра
автоматика: Автоматика
частотный: Частотный частотный
репортаж: Репортаж
системный: системную системных системном Системный системный системной системному системные Системная системного Системное
получаться: получается получаться получаются
анализ: анализ анализа Анализ анализе анализов анализу
фестиваль: фестиваля Фестиваль фестивале
нотариально: нотариально
сравнимый: сравним
недоступный: недоступны недоступен недоступная
больший: Большими большему большее большими Большая большую наибольший большая
соответствие: соответствия соответствие соответствии
следить: Следите Следи следить
доработка: доработку доработок доработки доработке доработка
кучка: кучка кучки
проходить: проходя проходит прохожу проходить проходят Проходит проходили
нелинейный: нелинейного нелинейных
псевдокод: Псевдокод псевдокоде
правый: правый правому правая Правое правую правое правым Правее правы
цеплять: цепляет
отечественный: отечественных отечественный отечественной отечественном
учёт: учёта учетом учет учета учёт учётом
оставаться: Остается остается Оставайтесь остаются остаётся оставаться
потом: Потом
ночь: Ночь ночи
оплата: оплаты
блокировка: блокировка Блокировка
составной: составных составной Составные Составная составные
лизинговый: Лизинговая
выводить: выводит выводят выводить
аккумулятор: аккумуляторов
разглядывать: разглядываем
множество: множеством множество множества множестве множеств Множество
обстановка: обстановку обстановки
спецификация: Спецификация
тяжёлый: тяжелее Тяжелое
ульяновск: Ульяновск
складываться: складывается
накачать: накачала
некоторый: некотором некоторым некоторую некоторая некоторого Некоторое некоторый некоторое
специальный: специальный специальные специального Специальные специальным специальными
отличный: отличное Отличный отличную отличные отличная отличный
представить: представлен представить представленный представлено представлены Представьте представила представлена представленных
аккаунт: Аккаунт аккаунта аккаунт аккаунты
соответствовать: соответствуют соответствует соответствовать соответствующую
материальный: материальной
градус: градусах Градус градуса градус градусов
фреймворк: фреймворков фреймворком фреймворк Фреймворк фреймворка фреймворках фреймворки
второй: вторых вторая вторую второго втором Вторая вторым
спецпроект: Спецпроекты
итоговый: Итоговое итоговое Итоговые итоговом итоговая
занятие: занятий занятии занятиях занятие
билайн: билайн
командный: командную
работодатель: работодатель работодателями работодателя работодателю Работодателям работодатели работодателей
броситься: бросилось
госуслуга: Госуслуг
удалять: удаляем
мнение: мнению Мнение мнение
обновление: Обновление обновление обновлении обновлениях обновлений обновлением обновления
онлайн: онлайне
указанный: указанная указанную Указанная указанными
структурный: структурного Структурные
противоположный: Противоположная противоположных противоположные противоположны
ответ: ответ ответом ответы Ответ ответе ответа Ответом ответов Ответы
обрабатывать: обрабатывал обрабатывать обрабатывает
фасад: Фасад
вершина: вершинах вершина вершине Вершины вершину вершины вершин
парень: парней
сведение: сведениям сведении сведений
ошибаться: Ошибались
цифра: цифра цифр
воспроизведение: воспроизведения воспроизведение
неординарный: неординарных
одиночка: одиночку Одиночка
иллюстрация: иллюстрация
наблюдатель: наблюдатель Наблюдатель
предположить: предположите предположить предположил
исправлять: исправлять
конторович: Конторовича
учётный: учетную учетная учётную учётной
пропустить: пропущенных пропущен
поддержать: Поддержать поддержать
собеседование: собеседование собеседовании Собеседование
видимость: видимости видимость
кормный: Кормен
китайский: Китайский китайская
брошюра: Брошюра Брошюре
алгебраический: Алгебраический алгебраических
вставка: Вставка вставке вставку вставка
выделять: выделяет выделяя
забавно: забавно Забавно
источник: источниками источнике источники Источник источник источников
показ: показ
освободить: освобождён
сервер: сервер сервером Сервера сервере сервера серверов серверу Сервер
опустить: опущу Опустим
актуальный: актуальных актуальными актуальные Актуальна актуальном
поставщик: поставщики поставщик
добавить: добавить добавлю добавил Добавить добавив Добавив добавлена добавили добавим Добавим добавлены Добавили Добавьте Добавленная добавленный
отозваться: отзовётесь отзовитесь
надежда: Надежда
штука: штука штук
разработка: разработкой разработку разработки разработка разработке Разработка
защита: защиты защиту защите Защита
принцип: Принцип принципов принципы принципами принципом принцип принципе принципам Принципы
ракета: ракетой
дружелюбно: дружелюбно
легенда: Легенда легенд
сообщать: сообщать Сообщать сообщает
должный: должны должна должен Должна Должен Должно должно
экран: экран экрана
ехать: едет
выстроить: выстроена
недостаточно: недостаточно
кратный: Кратный
простой: проста Простыми простую прост Простые простые простым проще простом простых простейший простого простое простая простейшем
закруглить: закруглить
употребление: употребление
неопределённый: Неопределённый неопределенному неопределенное
коллекция: коллекция Коллекция коллекций коллекциями коллекцией коллекцию коллекциям
дмитрий: Дмитрий
газообразный: газообразное
горьков: Горьков
затем: затем Затем
смочь: смог сможете смогу сможем смогли сможет
обязываться: обязуетесь обязуется
код: кода кодов коду Код коде код кодом
векторный: векторное векторных векторному Векторная Векторное векторном Векторный векторные
интерес: интересы интерес интересе интересов интереса интересах
адвент: адвенту
мобильный: мобильные мобильную мобильной мобильный мобильными мобильных Мобильном Мобильная Мобильное мобильного мобильном
основополагающий: основополагающих
ошибка: ошибок Ошибка ошибками ошибкой ошибке ошибку ошибка
увидить: увидить
включать: включаем включает включают включать
правообладатель: правообладателями правообладателей Правообладатель правообладателя Правообладателю
усвоение: усвоения
проверять: проверяем Проверяем проверяет проверять проверяема проверяя проверяю проверяющий проверяют
решить: решить Решил решил решены решили
здесь: Здесь
дополнительный: дополнительный дополнительные дополнительной дополнительного дополнительными дополнительных Дополнительные
нотификатор: нотификаторов
неотъемлемый: неотъемлемой
договор: Договора договоры Договорам договорам договорами договоров договора договор Договоров
связывание: связывание связывания связывании
помочь: помогут помог поможем поможет помочь
хранить: хранят хранит хранить храня храните храним
выпуск: выпуск выпуска Выпуск выпуске
устранение: устранения устранение
раскладка: раскладок
класть: Кладем кладет класть кладём
планшет: планшет
вика: Вика
наверняка: наверняка Наверняка
наоборот: наоборот
александр: Александр
правка: правки правка правок правкам
электронный: электронная электронными Электронная электронную электронный электронной электронных электронного электронные
незамедлительно: незамедлительно
определять: определяя определяемых определять Определяем определяющий определяют определяемому определяет определяющим
линейный: линейный линейного Линейный Линейное линейные Линейная линейной линейна линейными линейных
квалификация: квалификациях квалификации
пригодный: пригодна
бывать: бывают Бывали бывает Бывают
местный: местные
краснопресненский: Краснопресненская
извлекать: извлекать извлекающий
радиус: радиус Радиус
смежный: смежных
вызывать: вызывает вызывать вызываем вызывавшие
удача: удачу удачи
своеобразный: своеобразный
птичка: птичка птичкой птичку
сопровождаться: сопровождающемся
регистрация: регистрации регистрацию Регистрация регистрация
лента: Лента ленте
хайп: хайп
хвост: хвоста хвост хвосты
шагать: шагать
сбор: сбору сбора сбор Сбор сборе
настоящий: настоящему настоящая настоящей настоящие Настоящее настоящий настоящее Настоящий настоящих Настоящая настоящим настоящую Настоящим
вход: входе вход входа Вход
отдаваться: отдается
думать: думаю Думаю думай думаете думал думают думать
вместе: вместе Вместе
ставить: Ставлю ставить
спросить: спросил
штрих: штрих
кто: Кто Кому кого кому
знание: Знание знания знаниями знаний знание
сортировка: Сортировка сортировку сортировка
корявый: коряво
медиафайл: Медиафайлы
этап: этапов этап этапа этапах этапе
формирование: Формирование формированию формирование формирования формировании
задать: заданную задать задано задайте заданная задана Задать
машина: Машинах машины машине
нерейн: Нерейна
примечание: Примечания Примечание
создавать: создавали создавал создает создавать создаем Создаем Создаём
смотреть: смотрит Смотреть Смотрим смотрим смотря см См Смотрите смотреть смотрел
консольный: консольных Консольная консольная консольный
запрашивать: запрашивает
встретиться: встретиться встретится
создание: Создание созданию создание создании
себя: собой
купить: купил куплены Купить купить
сиэтл: Сиэтл
норма: нормам норму нормой
скорость: скорость Скорость скоростью
беларускать: Беларуская
они: ими Они ними
предлагать: предлагать предлагаемых Предлагаю предлагают предлагаю предлагает
информациевать: информациюя
отменять: Отменяем отменял
домашний: Домашний
зарегистрировать: Зарегистрирована Зарегистрированный Зарегистрирован зарегистрированы Зарегистрируйте зарегистрированный
выбрать: выбрана выбранной выбрали выбрано выберем выбрать выбрал Выберите
младший: младшим Младший младше младший
общаться: общаться
масштаб: масштаб
лимассол: Лимассол
добавлять: добавлять добавляем Добавляя добавляет Добавляем добавляемый
программирование: программирования программированием программировании Программирование программирование программированию
сделать: сделать Сделаем сделает сделаны сделал сделаем сделали сделана сделаю сделанную Сделав сделав сделанный Сделать сделан сделано
печать: Печать печати
конкурс: Конкурс конкурсу
логический: логических логическая
оборудование: оборудование оборудования
переменный: переменную переменных переменные переменным
применяться: применяются применяется
лебедев: Лебедева Лебедев
сориентироваться: сориентироваться сориентировались
поверхностный: Поверхностный
цена: цену цене цен цена
человечность: человечность
зиверт: зиверт
обобщить: обобщить обобщены
распоряжение: Распоряжением распоряжений распоряжении распоряжение
рекомендация: рекомендацией
содержание: Содержание содержания содержание
челябинск: Челябинск
приложение: приложении Приложений Приложение Приложении Приложению приложение приложением приложений Приложением
поддерживать: поддерживают поддерживает поддерживать
роботизатор: роботизатора
различный: различную различных различным различные
время: времени времена временем время Время
тренировочный: тренировочную
действие: действиям действием действие действии действию действий действиями действиях Действие
январь: январь января
банк: банк Банка банки Банки банках банка банке Банк
успешно: успешно
реализовать: реализующем реализовано реализовал реализовали Реализуйте реализована реализовать реализуют Реализуя Реализовать реализованы реализуйте реализовав
прокат: проката
который: которое которых Которая которому котором которыми которую которая который которые которого которым
дуга: дуги
развивать: развивают развивает Развиваем
техноавтор: Техноавтор
наследование: наследования наследовании наследование Наследование
библиотека: библиотеку библиотеках библиотек Библиотека библиотека библиотеками библиотеки библиотеке библиотекой
юрисдикция: юрисдикции
аналитик: аналитиком Аналитик аналитик аналитику аналитиков аналитики
рассмотреть: рассмотрены рассмотрен рассмотрено рассмотренные рассмотреть рассмотрим Рассмотрим
гордыня: гордыни
мешок: мешков мешка мешок мешках мешке
полюбить: полюбить
профессиональный: профессиональным Профессиональная Профессиональное Профессиональный профессиональное Профессиональные профессиональному
термодинамический: термодинамическая
абстрактный: абстрактными абстрактный Абстрактные Абстрактная абстрактным
классический: классические Классическая классических классический Классические классического
полезный: полезные полезна Полезные полезных полезным полезный полезными полезной полезного полезное полезную полезен
стандартизация: стандартизации
искать: искала ищем Ищем искать ищут
управление: управлению управление управлении управления Управление управлением
уникальный: уникальную уникальных Уникальных уникальная уникальное уникальный
сетка: сеток сетки сетку сетке
хранение: хранение Хранение хранения
последователь: последователи
давление: давления давлении
главный: главных Главная главные Главный главным
автор: авторов Авторы автор автором авторам автору автора Автор авторы
распознавание: Распознавание распознавание распознавания
подарок: подарки
повторить: Повторить
красный: красном красно красная
примерный: Примерный
фидбэк: Фидбэк
регулярно: регулярно
компаратор: компараторе
правомерность: правомерность
весенний: Весенние
основать: основанными основано основанный основан основанного
диалог: Диалоги
иной: иными ином иные иное иных иного
стараться: стараюсь старался
рекурсивный: рекурсивно рекурсивное
кушать: кушают
публиковать: публикуем Публикуем публиковать публикую
приниматься: принимаются принимается
блог: блога Блог блогах блоги блог
скрестить: скрестили
создатель: создатель Создатель
высота: высотой высоты Высоты высоту высоте высота Высота
подсветка: подсветке подсветки
вывод: вывод выводы Вывод вывода
называть: называют называть
локальный: локальном локальный Локальная локальное локальную
ситуация: ситуаций ситуацией ситуациях ситуация ситуацию
отмена: отмену отмене отмена отмены
правило: правилах Правил правило правилами Правилами правил правилам
неудобно: неудобно
редактировать: Редактировать
прибор: приборы
отказать: отказали отказать
объявлять: объявляет
текст: текста тексте Текст тексты текстов текст текстом тексту
конгресс: Конгресс
продолжаться: продолжаются продолжается
однопоточный: Однопоточное Однопоточный
упомянуть: упомянуть упомянули
автоматизация: автоматизация автоматизацию Автоматизация автоматизации
взгляд: взгляд взгляда взгляды
описать: описанных описать описанного опишу описаны описанными описано описанный Описан описав описал описанную
наложение: наложения
дамп: дампа дамп
указываться: указывается указываются
авторитетный: авторитетные
дополнительно: Дополнительно дополнительно
принимать: принимающих принимать принимаете принимали принимает Принимая принимаю принимаем Принимаете
пикап: пикап
столетний: Столетний
усиление: усиления
час: часов час часа
подать: подали
олег: Олега Олег
руководство: Руководство руководства Руководства руководство
переиспользовать: переиспользовать
корень: корнями корня Корень корнем корню корней корень
заодно: Заодно
бесплатно: бесплатно
компания: компаниях компания Компания компании компанией Компании компаний Компанией компаниям компанию
информационный: информационном информационных информационного информационный информационные информационной Информационные Информационная
выбираться: выбирается
популярный: популярными популярную популярный Популярные популярных популярная популярным
инженер: инженеров инженером инженер инженеру инженеры Инженер инженерам
особняком: Особняком
писатель: писатель
инструкция: Инструкция инструкцию инструкциями инструкцией инструкция
технология: Технологий технологий технология технологией технологиям технологиями
цикл: Цикл цикл цикле циклы циклов циклом цикла
посмотреть: посмотрим Посмотреть Посмотрю посмотреть Посмотрим Посмотрите посмотрит посмотрел
хунта: Хунта
знать: Знай знали знаем знает знают знал зная знаешь знать знаете знаю
аудит: аудит
выглядеть: выглядеть выглядит Выглядит выглядят
недостаток: недостатки недостатка недостатков
внешний: внешний внешнего внешние
конвертор: конвертор
учебный: учебный учебных учебная учебного Учебное учебное Учебный
отключать: отключаема Отключаем отключать
зашить: зашито
интеграл: интеграла интегралами интеграл Интеграл интегралов
результат: результатах результатам результатов Результаты результате результатом результата результату результат результаты
обязать: обязан обязано обязана
необязательный: необязательный
реальный: реальная реальных реальном Реальные
часто: Часто часто
дать: дан дало дадут дать Данная данная Дан даст Дано
исключать: исключаем
цитата: цитаты
довольно: довольно
офлайн: Офлайн офлайна офлайн офлайне
шрифт: шрифтов шрифта шрифт
структура: структуры структурой структурах Структуры структурам структуру структура
сообщить: сообщили сообщить Сообщить
владивосток: Владивосток
аналог: аналога аналогов аналоги аналог
применение: применений применением Применение применению применениях применение применении применения
доходить: доходит
изменение: изменение Изменение изменений изменениями изменении
вспомогательный: вспомогательный Вспомогательный
линейно: линейно
минус: минусах минусы минусов
характеризоваться: характеризующийся
пример: пример примерах примеров Пример примером Примеры примера примерами примере примеру примеры
рынок: рынка рынок рынке
исследование: Исследования исследованиями Исследование исследования исследований
профессионально: профессионально
пожертвовать: Пожертвовать
студа: студ
раскрытие: раскрытие раскрытия
известный: известные известнейший известен известных известную известны
сегодня: Сегодня сегодня
опубликовать: опубликованной опубликовал опубликована опубликован опубликовать опубликовало
изготовить: изготовить
наиболее: Наиболее наиболее
белсофт: Белсофт
нельзя: Нельзя
единоличный: единоличному
убедить: убедил
разместить: разместить размещенных размещённых размещенная размещенный размещенные
анализировать: анализируем анализировать Анализируем
март: марта
персистентный_массив: Персистентный_массив
сказать: Скажу сказали сказал скажут сказать сказано сказавший Сказал скажешь
установленный: установленными
российский: российского российскую российская российский российских российские Российской российской
софт: софт софта
операционный: операционных операционной
схема: Схема схеме схемой схемы схему
заметить: Замечу заметил заметили Заметим
вообще: вообще Вообще
конкретный: конкретных конкретную конкретным конкретные конкретном конкретного конкретный Конкретнее Конкретная конкретная
право: правом право прав Право права Права
остановиться: Остановимся Остановиться остановился остановимся остановиться
определить: определены определен определил определено определить определён Определите определена определили
фальшивый: фальшивыми фальшивая фальшивые фальшивую Фальшивые
проследить: проследите
прохождение: прохождения прохождение
производиться: производится
состоять: состояло состоит Состоит состоящую состоящее
сереализация: сереализацию
отсортировать: отсортировать отсортируем отсортирован
настройка: Настройка настройке настройками настройку настройка настройках Настроек настроек
портирование: портирования
механизм: механизм
нормаль: нормаль Нормаль нормалей
шаблон: шаблона шаблонов шаблонами Шаблоны Шаблон шаблоном шаблоны шаблон
хостинг: хостинге хостинг
скидка: Скидка
вена: Вена
загрузка: загрузки загрузкой загрузка
каннингем: Каннингем
кратко: Кратко
разрешать: разрешают разрешает
начало: начале начала
участие: участия участие Участие
вывести: выведена Выведите Вывести выведите выведет вывести
трактор: Трактор
подход: подходом подхода подходах подход подходов подходе подходы
андреевич: Андреевич
быть: буду суть будешь Будем е Будет Был будем Е будут будете
контроллер: контроллер контроллеры контроллерами контроллера
доступность: доступность
спорт: Спорт спорт спорта
константинович: Константинович
форум: Форум форуме
гарантировать: гарантирует
погружение: погружения погружение
контрвариантный: Контрвариантный
прогон: прогона прогоне прогонов прогон
газ: газов
цейтнот: цейтнота
буква: букву буквами буквой букв
словосочетание: словосочетание
сразу: сразу Сразу
решето: Решето
контейнерный: контейнерную Контейнерная
ахнуть: ахнут
справа: справа
попасть: попало попадет попала попасть
оперировать: оперируют
пологий: пологих
странно: странно
класс: классом классов класса классу класс классы Класс классе
условие: условиям условиями условиях условию условия условием условие Условия условий условии
иконка: иконок иконку
совкомбанк: Совкомбанк
умножение: умножение умножения умножением Умножение
лондон: Лондон
внести: внесут внести
использоваться: использовались использующимися использовался используются использоваться используется Используется
нелепый: нелепая
публикация: Публикация публикация публикацию публикаций Публикации публикации
обнаружиться: обнаружился
бакалавриат: Бакалавриат
рассматривать: рассматривая рассматривают рассматривать Рассматриваем
возвращать: возвращать возвращаемое возвращает возвращаем Возвращаем возвращающий
спойлер: Спойлер спойлеры
деятельность: деятельность деятельности
структурировать: структурирует
архитектура: архитектура Архитектура архитектуре архитектурой архитектуры
обсуждать: обсуждают обсуждаем Обсуждаем обсуждать
запрятать: запрячу
неожиданно: неожиданно
программист: Программист программисты программист Программисты программистам программистом программистов Программисту программисту программиста Программистов
сельский: сельское сельском
нур: Нур
бруной: Бруноям
перейти: перейду перейдя Перейти перешёл перейдем перейти
путешественник: путешественник
предварительный: предварительную предварительной предварительного предварительные
интерактивный: Интерактивный интерактивном интерактивных Интерактивных
кабинет: кабинетом кабинета кабинет кабинете кабинету
бороться: бороться
разрушать: разрушающие
ожидать: ожидающих ожидал Ожидают ожидает ожидаемый
максимум: максимума
наём: найм найма
переделывать: переделывать
широкий: пошире широкий широкого широким
однотипный: однотипные
написать: написан написали Напишите написанное Напиши Напишем напишите написанного Написать написана написал написав написано написанная напишем написать
двадцать: двадцатью двадцать
файл: файлов файлах файлами файле файл файлу файлы файлом файла
движ: движ
американский: Американская
элемент: элементу элементом элементами Элемент элементы элемент элементов Элементы элемента
сеть: сетью Сети сети сетями сетей сеть сетях
своевременно: своевременно
изобретение: изобретение
конвертировать: конвертировать конвертировал
подлежать: подлежат
разбор: разбор Разбор
корректный: корректное корректны
остаток: остатками Остаток остаток остатке остатков остатки
раз: Раз разу раза
причина: причина причинам причин причину причине
понимание: понимание понимания
повышать: Повышаем повышают
уйти: ушло Ушёл
сорм: СОРМ
мир: мира мир мире Мир
недавно: недавно
медленный: медленный
момент: моменте моменту момент моментом моментов моменты момента
некоммутативный: некоммутативными
никнейм: Никнейм
семь: семи семь Семь
программный: программного программному программных программная Программного программное Программные
полнота: полноты
пара: Пару пару пара пар пары
отображение: отображения отображение отображении
загрузить: загрузить
имя: имён имя Имя именем имен имени
обязательно: обязательно
положение: положениями Положении положение Положение положений положения
выдохнуть: выдохнули
сайт: сайты Сайт сайтах Сайта Сайты сайту Сайте сайтом сайт сайте сайта сайтов
андрей: Андрей
сторона: стороной сторону стороны стороне сторон Сторон
заполнять: заполняющий Заполняем заполнять
шаблонный: шаблонная Шаблонный
привет: привет Привет
значение: значением Значения значений значениях значения значениями значение значении значению
предшествовать: предшествующим
превьюшка: превьюшек
температура: Температура температура температуру температур температуры
повторение: повторений повторении
адаптивный: Адаптивная Адаптивный
русский: русском русские русский русского русской Русский
локатор: Локатор
автоматизировать: автоматизировать автоматизировали
сбалансированный: сбалансированными
курьер: курьеров курьеры
редакция: редакция редакцией Редакция
маркетинговый: Маркетинговые Маркетинговый маркетинговых
гребец: Гребец
возможность: Возможность возможностями возможностью возможность возможностям возможностей
конец: конец конца Конец конце концах
вычислять: вычислять вычисляют вычисляющий вычисляем Вычислять
переопределить: переопределите Переопределенная переопределить
связаться: свяжитесь свяжутся связаться Свяжитесь
выкидываться: выкидывались
востриков: Востриков
способ: способ способами Способы способы способов способом способа
субъект: субъектов субъектом
неделя: недель неделю Неделя неделя
удалённый: удаленно Удаленная Удалённая Удаленно
переработать: переработал переработали
неистовый: Неистовые
нулевой: Нулевая нулевого
современный: современная современному Современные современные современный современном
слово: слове слов словами слову слово словах
взрослый: взрослому взрослых
ватт: ватт
переопределять: переопределяя переопределяем
технический: технической Техническая техническую технический Техническое технического технических технические техническая Технические Технического Технический
огромный: огромное огромным огромного
репозиторий: репозиториев репозиторию репозитории репозитория репозиторий
ускорение: Ускорение
эндпоинт: эндпоинтам эндпоинтов
жаль: Жаль жаль
присваивать: присваиваем присваивает
исходник: исходниках исходнике исходники исходникам Исходники
экономика: экономики экономику
колесо: колеса
утро: утро утра
выделить: выделил выделенная выделить
процесс: процессами процесс процессы процесса Процесс процессов процессе Процессы
разный: разные разного разными разным разных разный
адрес: адресами Адрес адресам адресу адресов адрес адресом
поручать: поручает
выполнять: Выполняем выполняют выполняя выполняет выполняем выполнять
проделывать: Проделываем
скачивать: скачивает скачивал скачивать
практика: практику практике ПРАКТИКОЙ практикой практики практиками практик Практикой практика
тупо: тупо
различаться: различаться различается различаются
твой: твой твоих
строитель: Строитель
уезжать: уезжать
покупатель: покупателя
белград: Белград
ссылка: ссылка ссылки ссылке Ссылка ссылок ссылкой Ссылки ссылку ссылками
флаг: флаг
исправить: исправь Исправьте исправить
давать: дававшую давайте Давайте даёте дает даете даю дают давать
никто: никому никого никто
частый: частые частых частое Частые чаще частого
выполняться: выполняются выполняется выполнялись выполнялась выполняться выполняющаяся
джава: джава джаву
версия: версию версией версия Версия версиях
поставить: поставить поставь
необходимый: необходима необходимыми необходимом необходимой необходим необходимые необходимого необходимое необходимым необходимых
иннокентий: Иннокентий
ряд: рядами рядов ряда ряде ряд
поработать: поработать
план: планов план плана План планы планах
дом: дома Дом дом
очередь: очередь очередей
планировать: планируем планировать планирует планирую
третий: третий Третья третьими третьим третьего третьи третьих третья
сочинить: сочинены
запрос: запросах Запросы запросу запросы запросов запросе запроса запросом Запрос запросами запрос
добавляться: добавляться добавлялись добавляются добавляется
опровергать: Опровергаю
разгадывать: разгадывать
хабаровск: Хабаровск
архивировать: Архивировано
вариант: вариантов Вариант варианта вариантах вариантом вариант варианте Вариантов варианты
отношение: отношений отношение отношениях отношениям отношении
проверка: проверке проверка проверку проверки проверками Проверки проверкой Проверка
вакансия: вакансий вакансия вакансию вакансиях
нижний: нижняя Нижний
многословность: многословность
лимит: лимит лимиты
хакер: хакером хакеров хакеры
неизменный: неизменном
голосовой: Голосового
ум: ума
различить: различить
природа: природу природы
физический: физических физического Физическая физическое
подойти: Подойдет подойдут подойдёт подойду подойдет
угроза: угрозы
деление: деление деления делении
покупка: покупке покупку покупкой
магазин: магазины магазинов
написание: написанию написанием написания написаниях написании
солюшенс: Солюшенс
материально: материально
разброс: разбросом
минимум: минимумом минимума минимум
персонализировать: персонализированные
логин: логин логином логина логину
являться: являться являются являющиеся Являясь является Является
данный: данном данную
интервал: интервала интервале интервал
генеральный: Генеральный
прислать: присланное прислать прислал прислали присланную пришлют пришли
геометрия: Геометрия геометрия геометрией
определение: определению определения определение Определения
отметка: отметку
карьера: Карьера Карьеру карьеры карьеру Карьере Карьеры
формула: Формулу Формула формула Формуле формулам формул формуле
считаться: считаются считается
координата: координаты координат координатами координатам координату Координаты
дзен: Дзен
белоцерковский: Белоцерковский
нечего: нечего
подсказывать: подсказывает
директор: директор Директор директоров
математический: Математическая математические математического Математической математическое математических математический математическая
обладать: обладающие обладают
конвейер: конвейера конвейере
логика: логика логики Логика логикой логике логику
воспользоваться: воспользуемся Воспользовавшись воспользовались воспользоваться
опыт: опытов опыт опытом опыте Опыт опыта
куприянов: Куприянов
единица: Единицы единицам единицу единицах единиц единица единицей единицы
способность: способность
мой: моего Мой моему моё Моя мое мою моих моем
взращивание: взращивание
исполнение: исполнения Исполнение исполнении исполнение исполнением
мысль: мыслью мысль
специализироваться: специализируюсь
шведский: шведский шведского
позволить: позволит
показывать: показывают показывать показывает показывая показывающие
космос: Космос
обслуживание: обслуживания обслуживание
разработчик: Разработчики Разработчик разработчикам разработчиков разработчики разработчиком разработчик разработчика
подписаться: подписаться Подписаться подписался подпишутся
почта: почте Почты Почта почту почта почты
краткий: Краткие краткий Краткий краткая
попадать: попадающее попадала попадают попадать
приблизиться: приблизился
эратосфен: Эратосфена
тёмный: тёмную Тёмная
колпино: Колпино
савин: Савин
переключение: Переключение
подключение: подключение подключения подключению
зарплата: зарплатами зарплату зарплат зарплата зарплате
страна: стране странами стран Страна странах страны
декларативный: декларативном
цифровой: цифрового цифровую Цифровая Цифровые цифровых
википедия: Википедия Википедии википедии
красноярск: Красноярск
двоичный: двоичный Двоичное Двоичный двоичные
идея: идей идея идее Идея
содержать: содержать содержащую содержит Содержит содержащий содержащие содержат содержали содержала
арктика: Арктики
обозначение: обозначение обозначений Обозначение обозначения Обозначения
сосед: Соседи соседи соседей
игрец: игрец
нормальный: нормальную Нормальные Нормальная нормальная
микроконтроллер: микроконтроллере микроконтроллерами Микроконтроллеров микроконтроллеров
экспертиза: экспертизу
бесконечный: Бесконечное Бесконечная бесконечное бесконечные бесконечен бесконечную
свежий: Свежий свежие свежий посвежее Свежие
вставить: вставили вставить
усложнять: усложняет усложнять
згнёт: Згнётов
разложение: Разложение Разложения разложение
фирма: Фирма
учесть: учесть
вначале: Вначале вначале
скачивание: скачиваний скачивания скачивание
заказ: заказа Заказы заказы
развитие: развитии Развитие развития развитие развитию
назначение: назначения назначению Назначение назначение
рекурсия: Рекурсия рекурсией рекурсию
влиссидес: Влиссидес
патент: патентами патенты
комплекс: комплексах
душа: душе
даниил: Даниил
сжечь: Сожгите
гильберт: Гильберта
сходство: сходство
допущение: допущения
маркетолог: Маркетолог маркетолога маркетолог маркетологом
речь: Речь речь
уровень: уровне уровнем Уровень уровня уровень
атрибут: атрибуты Атрибуты атрибутам атрибутов атрибут атрибутами атрибута атрибуте атрибутах
решение: решениями Решение решение решения решениях решении решению решений решением Решения
переливать: переливаем
христианин: Христиан
расширение: расширениях расширения расширение Расширение расширений расширениям
конспект: конспект
волгоград: Волгоград
золотой: золотого Золотое Золотая
суть: сути
сдвигать: сдвигать
ожидаться: ожидается
замена: замена Замена замене заменой замену
набор: набором набору набор набора
религиозный: религиозному религиозными религиозных
уменьшать: Уменьшаем уменьшать уменьшаем
глубоко: глубоко
металл: металлы металл Металл металлов
аналогично: Аналогично аналогично
основа: основ основу основа основам Основа основе основами
взглянуть: взглянув взглянуть
президент: Президент Президента
свойство: свойств свойство
подписать: Подписан подписать подписанным подписанные Подписана
песочница: Песочнице Песочница Песочницу
количество: количеством количество Количество количеству количества
сменить: сменить
бот: боту боты ботах
смена: смены Смена смене
качество: качеству качестве качества качество
вхождение: вхождения вхождение вхождений
кейс: Кейс кейсах кейсы кейс кейсов кейсе
мигать: мигать
категория: категории категорий категориями Категория Категории категорию
отображаться: отображаться отображается отображалась отображаются
спрятать: Спрятали спрятать
учёный: Учёные Ученый учёных
возвращаться: возвращаться возвращается возвращаемся
прокачивать: Прокачиваем
наименование: наименованиями наименовании наименование наименованию
предсказывать: предсказывает
совпадать: совпадать
корн: корне
привести: приведённом приведёт приведённому приведены приведу приведённые приведен привести
митапа: Митап митап
функция: Функция функциями функций функцию функцией функция функциям функциях
партнёрский: Партнерская партнерских
вектор: векторов вектором векторы вектора Вектор вектор векторами Векторы
маркетплейс: маркетплейс маркетплейса маркетплейсах
правильный: правильные правильный правильными правильную правильного
ставка: ставок Ставок ставках
администрир: Администрир
держать: держащий
сфера: сферой сфера сфере
эрих: Эрих
феномен: феномен
обязательный: обязательными обязательные Обязательным обязательным обязательных обязательная
журнал: Журнал журналов
реклама: реклама рекламу рекламе рекламы Реклама
изучаться: изучаются
обмен: обмена обмен
контекстолог: Контекстолог
сидеть: сиди сидеть
достигнуть: достигшим достичь
близкий: ближе близки ближайшему ближайшем Ближайшие ближайших близка
энд: энда
предположение: предположение
применимый: применимыми
сталкиваться: сталкивались сталкивается
похожий: похожих Похожие похожа похожая похожи похожий похож
триал: Триал триал
фильтр: фильтра Фильтр фильтр фильтром фильтры фильтров
познавательный: познавательно
требовать: требуют требовать требуем требуя требуемое требуемый Требовать требующий требуемая требует требуемого требуемой
облако: облаке Облако облаков
лежать: лежать лежащие лежала лежит лежат
роль: роли роль ролью
статичный: статичный
обновить: обновить обновлённый обновил обновлены Обновить Обновлено
приглянуться: приглянулся
палиндром: палиндромом
анализатор: анализатор
выгружать: выгружаем
старинный: старинные старинных
делиться: делюсь делиться делитесь делятся
айтишник: айтишников айтишника
ответить: ответил ответим ответит Ответить
исследовать: исследуемого
июнь: июня
давно: давно
буклет: Буклет буклета
подставить: подставить подставленными
продуктивность: продуктивность
дообучаться: дообучается
отдел: отдела отдел отделе
атмосфера: атмосферу Атмосфера
геолокация: геолокацию
сотрудник: сотрудника сотрудникам сотрудников Сотрудники
хаб: хабом
расширить: расширить расширенный Расширьте расширив
энергия: Энергия
посягать: посягает
соображение: Соображения соображениям
ждать: жду ждет ждут Жду ждём ждёт ждать
оказываться: оказывается Оказывается оказывались оказываются
обратиться: обратиться обратитесь
правильность: правильность
утечка: Утечки утечки
привязка: привязку
связь: Связи Связь связи связь связей
столбец: столбца столбец
пока: Пока пока
шпаргалка: шпаргалка Шпаргалка
превратить: превратить
объяснение: объяснением объяснение
длина: длину длиной длина длины длине длин Длина
директ: директ Директ
московский: московском Московская Московский
фронт: фронте фронта фронт
поступать: поступать поступал
крошка: крошка Крошка
ассоциироваться: ассоциируется
общественно: общественно
ввод: Ввод
контекст: контекст контекстах контексте контекста
давыдов: Давыдов
теория: Теория теорию теории теория
контейнер: контейнерах контейнеры контейнер контейнеров контейнера контейнером контейнерами
уметь: умеет уметь умеют умеем
передаваться: передаётся передается передаются
тревога: тревога
подразделение: подразделение
советовать: советую советуем
информатика: информатик информатике
целый: целая целых целые
петь: пет
приложить: приложить приложен приложив приложил
обновлять: обновляем обновляет Обновляем
произносить: произносить
нейронный: Нейронные нейронными нейронных
канал: канале канал каналов Канал
ключевой: Ключевую ключевому ключевое Ключевые Ключевым ключевых ключевой ключевого
поддерево: поддерево поддеревья поддереву поддеревьями поддеревьев поддеревом поддереве
спокойный: спокоен
вес: Вес вес весов весу весом веса
федулай: Федулаев
строить: строит строили
александер: Александер
единый: Единый ЕДИНЫЙ
клик: клика
улучшение: улучшение улучшения улучшению
полноценный: полноценного
привносить: привносит
тип: типа типу типом типам Типы типов тип Тип типе типы
девчата: девчата
сдвиг: сдвигу сдвиг
база: база базой баз базам базами Базы базы База базу базе
уведомление: Уведомления уведомлений уведомления уведомлениях Уведомление
глоссарий: Глоссарий
нарушать: нарушать нарушает нарушая
высоконагруженность: высоконагруженность
стандартный: стандартная стандартных стандартному стандартные стандартную стандартном стандартный стандартное стандартными
наборщик: Наборщик
качальщик: Качальщик качальщиков качальщик
методист: Методист
проход: проходе проходов прохода
выигрыш: выигрышей
выучить: выучу выучить
кредит: Кредит
падение: падение падений падения падении
конструкция: конструкция конструкциями конструкцию
удобство: Удобство удобства удобством
нагрузка: нагрузки
экзопланета: экзопланетах
закрытый: закрытыми
находиться: находится находятся
смартфон: смартфон смартфона смартфоне
промежуточный: промежуточных промежуточную
уведомить: уведомив Уведомили уведомить
корневой: корневые корневую
запуститься: запустилось запустится
поток: поток потоке Потокам потоков потоки потока потоком
пот: пот
надеяться: надеюсь надеются Надеюсь
действовать: действовало действуем Действующая действовать действует
модем: модемов
обучить: обучил
выбрасывать: выбрасывать
прошедший: прошедшая
очередной: очередную Очередные
смешной: смешное
топика: топик топике топика
располагать: располагать
удаться: Удалось удалось удалась
мультик: мультика
управлять: управляющую управлять
выполнение: выполнении выполнения выполнению выполнение
однозначно: однозначно Однозначно
пароль: паролю пароль Пароль паролем пароля
пойти: пойдет пойти пойдешь пойдёт
строй: строя
беккерель: беккерель
валидация: Валидация валидацию валидацией
антипаттерн: антипаттерн
провалидировать: провалидирует провалидировать
настроить: настроить настроенных настроено настроили Настроим
графика: графика графике Графика
фак: фак
вкладка: вкладку вкладке
россия: Россия России
магнитогорск: Магнитогорск
пояс: пояса
полигональный: Полигональное
конфиденциальность: Конфиденциальность конфиденциальности конфиденциальность
честно: честно Честно
мастер: мастер Мастера МАСТЕР Мастер мастера
скобка: скобкой скобки скобками
продолжение: продолжение продолжения продолжением продолжении
заменить: заменить заменил заменив заменит
справка: справке Справка справки
литература: Литература
дробный: дробными
видеоматериал: видеоматериалы
сын: сыновей сыновья сына сыне сын сыновьях
пономарёв: Пономарев
установить: установлен установили установлена установить установлены установим установленном
ты: тебе
состав: состав Состав составу
царица: Царица
пётр: Петр Пётр
изменить: изменили изменен изменена изменено изменить
экзамен: экзамен экзамена экзамене
отправитель: отправитель
мера: мере мерам Мера мер
контекстный: контекстном Контекстная контекстной контекстное
виртуализация: виртуализацией
артефакт: артефакты
место: места Место месту месте местах место местами
рисунок: Рисунок рисунке
самостоятельно: самостоятельно
компетенция: компетенции компетенций
эквивалентность: эквивалентности
проставлять: Проставляя
хостер: хостеров
проблема: проблему Проблема проблемами проблема проблемой проблем
разбирательство: разбирательств
заранее: заранее
ныне: ныне
делегирование: Делегирования делегирование
таргетолог: Таргетолог
стек: стекам стеках стеке
пункт: пункты пункт пункта пунктам пункте Пункт пункту пунктов
финансы: финансами Финансы
доступный: доступные доступная доступными доступной доступным доступных доступный доступен доступного доступны
профилирование: Профилирование профилирование
прикинуть: прикинуть
авить: Авито
специализация: специализациям Специализация специализациях
брест: Брест
проверить: проверить проверен Проверить Проверьте проверим проверены проверенной
ведомство: ведомство
джуниор: Джуниор джуниор
помнить: Помню помнить помнит помню
преимущество: преимущество преимуществом
шанс: шансы шансов
редактура: редактура Редактура
фармацевтический: фармацевтические
производство: производстве производства
пятница: пятницу пятница
он: Он нему нём
запрещать: запрещаем запрещать запрещает
сценарий: сценария сценариев сценариями сценарий
базовый: базовых базовыми базовый базовые базовая Базовый базовой
входить: входит входили
моушный: Моушен
прописать: пропишем
менять: меняет меняют меняющие Меняем менять меняем
нужда: нужды
полотно: полотно
музыка: музыка
верный: верного верна
поздний: Позже
интересоваться: интересовался Интересующийся
построение: построение построения Построение построению построении построением
вероятность: Вероятность вероятность вероятностей
значок: Значки
маппинг: маппинга
вернуть: вернуть вернем Вернём вернет вернут вернём
быстрый: быстрее быструю быстрыми Быстрый быстрая быстрый быстрых
язык: Язык языками языка язык языках Языки языком языке языков языки
даваться: даются даётся
идеальный: идеальный идеального
буча: Буч
представитель: Представитель представитель представителей Представителям представителя Представителей Представители
предусмотренный: предусмотренными
вытекать: вытекают вытекающие вытекает
бетфэйр: Бетфэйром
логирование: логирование логирования
знакомство: знакомством Знакомства знакомства
вильгельм: Вильгельма
обратный: обратную обратные обратного Обратные обратное обратная Обратный Обратная обратным
евклидов: евклидовом евклидовыми Евклидово
уральский: Уральский
утверждать: утверждать утверждает утверждаю
туда: туда Туда
увидеть: увидел увидим увидеть увидели увидите
расширять: расширять Расширяем расширяют
костыль: костылям костыле костыли
зависеть: зависит зависят Зависящий зависело зависящую
прогноз: прогноз прогноза
построенить: построеня
бережно: Бережно
эксперимент: эксперименты экспериментах Эксперимент эксперимент эксперимента экспериментов
патентный: Патентное
взаимосвязь: взаимосвязи
бурак: Бураков
зацепка: зацепки зацепка зацепку
видеть: видел видим видит вижу видеть Видите
функциональный: функциональное функциональных функциональные функциональный функциональным Функциональное функциональному функционального функциональными функциональная функциональной функциональном Функционального
мочь: Могло можете могли Можем можем могу могла Может могут
скрывать: скрываем скрывает
доказываться: доказывается
якоб: Якоб
взять: возьмем Возьмём возьмите возьмет взяли возьмём взять взял
протяжение: протяжении
микросервис: микросервисов микросервис Микросервисы микросервиса
четыре: четыре Четыре
вынужденный: вынужденная
заниматься: занимаюсь занимаетесь заниматься занимается занимающихся
описание: описания описании Описание описание
граница: границе границы границами
равновероятный: равновероятны
задаваться: задаются задаётся задается
немедленно: немедленно
собирать: собираем собирать Собираем
требование: требований требованию требованиями Требования требование требованиям требования
взвешивание: взвешивания взвешивание взвешиванием взвешиваний взвешивании взвешиваниях
тензор: Тензор тензоры тензор
добрынин: Добрынин
домен: доменах доменов доменами домен
опция: опция
гостиница: гостиницу
богатый: богатую
корректура: корректура
государственный: государственном государственную Государственная государственные государственного
совет: Советы совету совет советов советы
такой: таком Такое такими таким Таким такого таких Такие такую такие такое Такой такая
упорядочить: упорядоченный упорядоченная
темп: темпе
случиться: случится случилось
создаваться: создаются создается создаваться
разделить: разделим разделены Разделим разделить разделили
цепочка: цепочку Цепочка
плата: плат
распределение: распределении
машинный: Машинное машинному машинное машинного машинным машинный
фрилансер: фрилансер
сообщение: сообщений Сообщение сообщение сообщениями
вылечить: вылечили
продюсер: продюсер
карман: кармане кармана
столбцы: столбцов столбцами
положительный: положительных положительные
останавливаться: останавливаться
обеспечение: обеспечения обеспечению обеспечение Обеспечение
комплект: комплект комплекте
подключать: подключать подключают Подключаем подключаем
налицо: налицо
симпсон: Симпсона
приведение: приведением приведении
эпичный: эпичный
основываться: основывается Основываясь основываются
измениться: изменилась изменится изменились изменился
таганрог: Таганрог
коротко: Коротко
тестовый: тестовое тестовом тестовую тестовый тестовыми тестовые
аналогичный: аналогичная аналогичные аналогичным Аналогичная аналогичного аналогичную аналогична аналогичное Аналогичную
доступ: доступа доступ Доступ доступе
последствие: последствий последствия последствиями
лямбда: лямбду лямбдами Лямбда
два: две двум двумя
праздничный: праздничный
футболка: Футболка
засоряться: засоряются
пользование: пользования пользовании пользование
запомнить: запомнить
несколько: несколько нескольким нескольких Несколько
левый: левое левая левыми левую левом левому левые
бедно: бедно
вина: вины
увеличиваться: увеличиваются увеличивается увеличивающиеся
лычко: лычку
появиться: появится появились появилось появятся Появились появилась
непрерывный: непрерывная
нагрузочный: нагрузочному Нагрузочное
сохранение: сохранения сохранением Сохранение сохранении
вызов: вызовы вызову вызовов вызова вызове
отдавать: Отдаем
пропасть: пропадет
возникнуть: возник Возникли возникла возникшие возникло возникнет возникших возникшего возникнуть
выражение: выражением выражение выражений выражениях выражения
никак: никак
важный: важней важная важных важное важными важный важные
изображение: изображение изображений Изображения изображении изображения
энциклопедия: Энциклопедия энциклопедии энциклопедия
циферблат: циферблата
июль: июля
сергей: Сергеем Сергей
спикер: спикеров Спикеры спикерами спикеры спикером
районный: районном
сомневаться: сомневаетесь
практически: практически Практически
палец: пальцах
спор: споры
екатерина: Екатерина
череповец: Череповец
измерение: измерений измерении измерения измерениях
репозитооия: репозитооий
квадрат: квадратов
выбирать: выбирать выбираем выбирая Выбираем выбирает
сохранить: Сохраним сохранить сохранено сохранит
метрический: Метрическая метрический
успешный: успешную успешных успешному успешным
ушанка: ушанкой
аннотация: аннотация аннотацию аннотаций аннотациями аннотациям
всегда: Всегда
автоматизатор: автоматизатора автоматизатор автоматизаторов
обучение: обучению Обучение обучения обучение
претензия: претензии претензий
транспонировать: Транспонированная
сборка: сборкой сборки Сборка сборку
контора: контора
один: одном одних одним одно одну одному одни Одним Один Одна одна Одно
оттенок: оттенков
многомерный: многомерные
заработок: заработка
заходить: заходит заходя
последовательность: последовательность
статья: статьей статья статьях Статья Статьи статью статьями статье статьи
море: моря
потенциальный: потенциальными
тема: теме тема тему темам
мышление: мышления
периодически: Периодически
продуктовый: продуктовую продуктовый продуктовой Продуктовый
перевод: перевод Перевод перевода Перевода
отправиться: отправится отправилось
разбиение: разбиению разбиении разбиения разбиение разбиений
порог: Порог
фриланс: фриланс фрилансе Фриланс
необходимо: необходимо Необходимо
ввести: Введено введенного ввело ввести введены
глубокий: глубокие глубокий Глубокое
говард: Говард
вырабатывать: вырабатывать
ассоциативный: Ассоциативный
аспект: аспекты
загружать: загружать загружаем загружаемое
параллелограмм: параллелограммов
тот: Те ту те Тех тому та тех
существовать: Существует существуют существует
связный: Связный
сознание: сознание
труд: труде труд трудах труда
приглашение: приглашения приглашению
карьерный: Карьерная Карьерные карьерные карьерного Карьерный
извне: извне
захотеться: захочется
обработка: обработкой обработке обработку обработка обработки Обработку Обработка
прототип: прототип Прототип
задача: задач задаче Задачу задачами задачи Задача Задачи задачу задача задачей задачах задачам
делать: делают Делайте делаю делала Делаем делающие делать делайте делаем делает
частота: частот частотами
изначальный: изначальные изначальное изначального
мессенджер: мессенджера мессенджере
стремиться: стремились стремится Стремимся
нефть: Нефть
снова: снова Снова
джуна: джуну джуна Джунами
группа: группы группу Группа групп группой группе группа
востребовать: востребовано востребованными
стенд: стенда стендах стенд стенде
местоположение: местоположение
предусмотреть: предусмотрено предусмотрены предусмотрена
обить: обьем
это: Этого этим
астроном: астроном Астрономы
взлом: взлом
потребовать: потребовать потребует
обидеться: обиделись
горизонтально: горизонтально
починить: починить
номер: номером номера номеру номер
заключение: Заключение заключения заключением заключение
табличный: таблично
перестановка: перестановка
разовый: Разовое
возрастать: возрастает
ресурс: Ресурсы ресурсы ресурсах ресурса ресурс ресурсов ресурсам
практический: практических Практическая практического практические практическая практический Практические Практический
ретроспектива: Ретроспектива
причинить: причинить
императивный: императивный императивных императивного
выложить: выложил выложены выложен выложу выложить
минимальный: минимальный минимальную минимальные минимального минимальным минимальное минимальных
деньга: деньги
глубина: глубина
обширный: обширного обширнее
носить: носить
прежний: прежнему прежними
семья: семьи Семья
модный: Модные модные
процессор: процессором процессор
разнообразный: разнообразных
применительно: применительно
перекур: перекурами
согласный: согласны согласен
географический: Географические
эффективный: эффективные эффективный эффективному
акт: актах
тег: Теги тег теги
объект: объекты объектами Объект объекта объектов объекте объектах объектом Объекты объект объекту
реквест: реквестов
асимптотик: асимптотики асимптотику асимптотика
подписка: Подписка Подписки подписку
рассчитать: рассчитан рассчитана
вырасти: выросло
билинейный: Билинейная
запустить: Запустим запустим запустил запустили запустить
пользовательский: пользовательского Пользовательское Пользовательского Пользовательские
удовольствие: удовольствием удовольствие удовольствия
адаптироваться: адаптироваться
конвертация: конвертацию
вклад: Вклад вклад
единичный: Единичная Единичный единичный
общественность: общественностью
спортмастер: Спортмастер
выгодный: выгодным
докер: докер
спороть: спорю
поддельный: поддельных
сводиться: сводящихся сводится
максимальный: Максимальный максимальное максимальная максимальную максимальному Максимальное максимальный
триста: Тремстам
добиться: добившись добиться
доставать: достаём
допуск: допуска
ангстрем: ангстрем
уязвимость: уязвимостях уязвимость уязвимостями уязвимостей
толковаться: толкуется
нажимать: Нажимаем нажимает нажимать Нажимая
маркет: Маркета
страшный: страшен страшная страшного
высокий: высокая Высокая высокую высоком высокого Высшая высоким высокие высшего
указывать: указывать Указываем указывает указываем
ячейка: ячейках
встречать: встречая встречать встречал
собственный: собственный собственных собственную собственному собственном Собственное собственными Собственный
классик: классик
карта: картах карты Карты карта карт
самоучитель: Самоучитель
процессуальный: процессуальным
сюрприз: Сюрпризы
страдать: страдай
рассказывать: рассказывали рассказываю рассказывать Рассказываем
антон: Антон
стол: стол
вспомнить: вспомнить вспомнил Вспомнил
доказательство: доказательств Доказательство доказательстве доказательство
лаконичный: лаконичное лаконичный
расстаться: расстались
вендор: вендора вендору вендорами
перебор: перебором перебор перебора
выйти: вышли вышло Вышел
выходить: выходит выходил
десктоп: Десктоп
полоска: полоской
история: история историю История историей
альтернатива: альтернативу
применить: применить применив Применив Применить
корпоративный: корпоративные корпоративного корпоративный Корпоративные
плоский: плоский
питер: Питер
собака: Собака
наложить: наложить
отказаться: отказаться
разбрызгиватель: разбрызгивателя
обратить: обратив обратить Обратите
зарубежный: зарубежного зарубежными
веб: Веб веб
личный: личную личный личными Личный
фактически: Фактически фактически
ничто: ничто
сохранять: сохраняем сохранять сохраняет Сохраняем сохраняя
прийтись: придется придётся пришлось Придется Пришлось
сходный: сходных
праваяграница: праваяГраница
пометить: пометил помечена помечены
изобретать: изобретать
карточка: Карточки карточки карточкой
пропускной: пропускная
исследовательский: исследовательских исследовательского
усложнение: усложнения усложнении
наступить: наступила
параллелепипед: параллелепипеда
устаревший: устаревшими
приёмник: приёмник приёмника приёмнике
следующий: следующими следующую Следующая
астероид: астероида
выдавать: выдавая выдавать
физика: физике физику Физика
икс: Икс
скаляр: скалярами скаляр
нота: НОТА
опечатка: опечатка
доля: доля
комбинация: комбинацией комбинацию комбинаций
телефон: Телефон телефон телефона
понятно: Понятно понятно
вымирать: вымирают
освоить: освоить
догадаться: догадаться
добавиться: добавились добавится добавятся добавиться
токенизация: токенизация
ярославль: Ярославль
наследоваться: наследоваться наследуемся
администрирование: администрирование Администрирование
рукописный: рукописных рукописные
кандидат: кандидатов кандидата кандидаты кандидатам кандидат
устройство: устройство Устройстве устройств Устройства Устройство устройстве устройства
крутой: крутых крутые
дихотомия: Дихотомия
подготовка: Подготовка подготовке подготовки подготовка подготовкой
минута: минута минуту минут минуты
коммерческий: коммерческой коммерческого
окончание: окончания окончанию
поменять: Поменять поменяны поменяв поменяем поменять Поменяем
заключать: заключает заключая заключаемыми
подписание: подписании подписания
комфортный: Комфортные
оказаться: оказаться оказалось оказались окажутся
безопасность: безопасности безопасностью Безопасность безопасность
приятно: Приятно
украсть: украл
архитектор: архитекторы архитектора Архитектор архитектором архитектор
частный: частных частное частные
сканер: сканер
научиться: научилась
инновационный: инновационных инновационными
влево: Влево влево
уехать: уехать
ручка: ручками
запускаться: запускались запускаемся запускаются запускается запускаться
добрый: добрый Добрый
корпускулярный: корпускулярно
автотест: автотестов автотест автотестах
интегральный: Интегральное Интегральные
разряд: разряда разрядам разряд
коллинеарность: Коллинеарность
задержка: задержками
рука: руки Руками руку руках руками
дизайн: дизайне дизайна Дизайн дизайном дизайн
наслать: нашли Нашли
оценивать: оценивали оценивать
предпочитать: предпочитаешь
миллион: миллионов миллиона миллионы миллион
насколько: Насколько насколько
овладевать: овладевают
бесполезный: бесполезном
нога: ноги
процедура: процедуры процедуру Процедуру
сложиться: сложившуюся сложиться
выборка: выборку выборке выборки
андерс: Андерса Андерс
пробел: пробел пробела пробелы
сомножитель: сомножителей
аргумент: аргументы аргумент
произвольный: произвольной Произвольные произвольных произвольными
организация: организации организациях организация организаций Организация
вечер: вечера вечерами
расстраиваться: расстраивайтесь
ядро: Ядро ядра
тысяча: тысячами тысяч
конечный: конечных Конечное конечная конечный
лишать: лишает лишают
присваиваться: присваивается
денис: Денис
назад: назад Назад
контрибьютер: контрибьютеров
обсуждение: обсуждения Обсуждение
вопрос: вопросы вопрос вопроса вопросам вопросе Вопросы Вопрос вопросом вопросов
чаша: чаше чашах чаши чаш чаша чашу
заключаться: заключающийся заключаться заключается заключаются
разъяснить: разъяснили
представиться: представились
размять: размять
квадратичный: Квадратичная
консультирование: консультирование
компьютерный: Компьютерное компьютерной Компьютерные компьютерного компьютерных
бедный: бедном
греф: Грефа
угол: угла угол углы
собрать: собрал собранная собраны собрана собрать
золото: золота золото
десять: десять
самый: самое самыми самую Самая самые самый самая самым самых Самое Самый
паттерн: паттерна паттерн Паттерн паттерны паттерном
выпустить: выпустили выпустила
отдельный: отдельных отдельному отдельном отдельный отдельные
привычка: привычка
независимо: независимо Независимо
плагин: плагина плагинами плагином Плагин плагину плагин плагине плагинов
килограмм: килограмм
редко: редко
первоначально: Первоначально
поболтать: поболтать
законный: законных законные
совершить: совершить совершены
компьютерщик: компьютерщика
упереться: упёрся
доминация: доминация
популярность: Популярность популярностью популярность
бред: бред
требоваться: требуется требуются Требуется
критически: критически
способный: способен
указать: указан укажем Укажи указано указать
шутка: шутка шутку
присвоить: присвоить
вырезать: вырезать вырезано
ноябрь: ноября
самоцвет: САМОЦВЕТЫ
задание: заданию задание заданиям задания заданий заданиями
платить: Платить платить
обратно: обратно
реализация: реализацию Реализация реализацией реализаций реализация реализации
любопытство: любопытством любопытство
алина: Алина
абсолютно: абсолютно
плюс: плюсы Плюсы Плюсом плюсах
осуществляться: осуществляется
либерия: Либерии
польза: пользу польза
побежать: побегут
пригодиться: пригодиться пригодится
сложность: Сложность сложностей сложность
энтерпрайза: Энтерпрайзу
пять: пяти пять
предложить: предложил предложили предложить предложенное предложенных предложит
русскоязычный: русскоязычных русскоязычное
переработка: переработку переработке
упасть: упадет
присутствовать: присутствует присутствуют
ломать: ломает
погода: погоду погоды
примерно: примерно
далее: далее ДАЛЕЕ Д Далее д
исход: исходов исхода исходу
толстый: толстую
украина: Украина
поэтому: поэтому Поэтому
хорватский: Хорватская
эконива: ЭкоНива
исправляться: исправляются
правовой: правовое Правовые
список: списку Список списков списком списке Списки списки список списка
английский: английским Английский английском английского
ключ: ключом ключа ключи ключу Ключи ключей ключ ключами
кинотеатр: кинотеатр
желание: желанию
дефект: дефект дефектов
страница: страницу страница странице страниц страницах
намного: намного
побочный: побочных
знакомиться: знакомитесь знакомиться
трансформировать: трансформировать
дальнейший: дальнейшей дальнейшему дальнейшего дальнейшем
сбис: СБИС
балашиха: Балашиха
чемпион: чемпионы
хотеться: хочется Хотелось хотелось
прибыль: прибыль
спам: спам спама
прилагаться: прилагается
порождать: Порождающие
владелец: владельцем владельца
приносить: приносит
запуск: запуска Запуск запуск запуском запуске
свидетельствовать: свидетельствует
битов: битов
основательный: основательное
долгий: дольше долгими
смольянин: Смольянинов
симметричный: Симметричная
течение: течение
точность: точности точность точностью Точность
промежуток: промежутке
парсить: парсить
она: Она неё
вычисление: вычислениях вычислении вычислений вычислением вычисление
половина: половине половины половина
объём: объема объёма объём объеме объёмы
генерация: Генерация генерации
оперативно: оперативно
инвестиционный: инвестиционный инвестиционным
урегулировать: урегулированные урегулировать
вполне: вполне
нормировать: нормированными
предоставлять: предоставляют предоставляемом предоставляемых предоставляю предоставляемого предоставлять предоставляет
строковый: строковый строковое
кортеж: Кортеж кортеж
информирование: информирования
фстэк: ФСТЭК
прекратить: прекращена прекратить
павел: Павел
партнёр: партнеров партнером Партнеры партнер партнеры партнерам Партнер
инженерный: инженерных инженерные
электрон: электроне электрон
заинтересовать: заинтересовал
русификация: русификация
разрядный: разрядная
десятилетие: десятилетия
мультимодальный: Мультимодальные
размещение: размещение размещением размещения размещении
пополнение: пополнении
раскопка: раскопки
потеря: потерю
рождение: рождения
технофобия: Технофобия
калининград: Калининград
спроста: спроста
осуществление: осуществлением осуществления осуществлении осуществление
пушкин: Пушкин
логироваться: логируется логироваться
локально: локально
искусственный: искусственного искусственный
пониматься: понимаются понимается
отключить: отключен отключить
распространение: распространением распространении распространение распространения
отправляться: отправляется отправляемся Отправляемся
отсутствовать: отсутствовать отсутствует Отсутствующие отсутствуют
настроение: настроение
перс: перс
прочее: прочего
устроиться: устроиться
желаемый: желаемому желаемый желаемого
власть: власти
продолжать: продолжаем продолжает Продолжаем продолжать продолжают
ознакомление: ознакомления
задачка: задачек задачку задачки задачка Задачки
конкретно: конкретно
подтвердить: подтвердило подтвердили
уверенно: уверенно
книжный: Книжная
рад: рад
сбить: собьем
аэродинамический: Аэродинамический
сопряжение: сопряжение
согласиться: согласитесь Согласитесь
ваш: ваша ваше вашего Ваш Ваши вашу ваши Ваша ваших вашем ваш Вашему
наводить: наводит
действительный: действительных действительными
преждевременный: преждевременному
потерять: Потеряли потерять потеряли
тагир: Тагир
охлаждение: охлаждении
передать: передать переданного переданное переданные передан передадим переданным передали
придумать: придумать придумал придумано придуманы
рефлекция: рефлекцию
вёрстка: Верстка верстка
запрет: запрет запретов запрете
нести: несет
скелет: скелет
пул: пулу пул Пулы Пул пула
алгоритмист: алгоритмист
эксперт: экспертам экспертов Эксперт эксперт эксперты экспертами Эксперты
поведение: поведение поведении поведением поведения
россиянин: россиянами россияне
сейчас: Сейчас
происходить: происходит происходящих происходить
раскрыть: раскрыт раскрыла
егоров: Егоров
конференция: конференция конференциях Конференция конференций
оборот: оборот оборотах оборота
отличие: отличии отличие
скилла: скилл скиллы
посредник: Посредник посредником посредника
контакт: Контакты
предназначить: предназначенный предназначенные предназначенная предназначен предназначенных предназначена
текстовый: текстовый текстовую
накидать: накидать
мапить: мапить
отчётность: Отчетность отчетности
вербицкий: Вербицкий
неполный: неполные неполна Неполный
реально: реально
геометрический: геометрической Геометрическая
отметить: Отметим отметить отмечу
панама: Панамой панама
разметка: разметке разметкой
изучать: изучаемые Изучаем Изучающие изучали изучаю изучать
признать: признаны признаете
интеграция: интеграция интеграциями Интеграция интеграции интеграций интеграцию
часть: частей часть частями Часть частью
влезть: влезть
экземпляр: экземпляров экземпляр экземпляра экземпляры экземпляром
затронуть: затронули затронем
методический: Методические
кружка: кружка
льсия: льсия
прочтение: прочтения прочтение
выставить: выставив
поддерживаться: поддерживаются поддерживается
пороша: порошу
совершение: совершения
так: т Т
сегодняшний: сегодняшнем
соглашаться: соглашается соглашаетесь соглашаемся
механика: Механика механике механика
занимательный: Занимательные занимательные
продукт: продукту продукты продуктах продуктом продукта продуктов продукте Продукт продукт
поломать: поломать поломали
химия: химии
проработка: проработки
целое: целом
грабли: грабли грабель
будапешт: Будапешт
окружение: окружения окружении окружение
следствие: следствии следствие
привлечь: привлечёте
инвестор: инвесторы
регрессионный: регрессионные Регрессионное
хитрость: хитрость
отменить: отменены отменённые Отменить отменить
кибератака: кибератак
разработать: разработали разработанную разработал разработать
виктория: Виктория
повысить: повысят повысить
опытный: опытные опытными опытным
вылет: вылета
клуб: Клуба
описывать: описывали описывающую описывает описывал описывать описываем описываемых
отдельно: Отдельно отдельно
отрезок: отрезков отрезка отрезок
почитать: почитать
знакомый: знакомый знакомо знакомы
приближение: приближения приближение
изучить: изученное изучить изучите Изучите Изучи
выброс: выбросов
фича: фичу
усмотрение: усмотрению
глянуть: глянуть
неудивительный: Неудивительно
предлагаться: Предлагается предлагаются предлагается
генетический: Генетический
паспортный: паспортных
математик: математик математика Математика Математик
подключиться: подключиться
доставить: доставить
грамотность: Грамотность
жигарев: Жигарев
клавиатура: клавиатур клавиатуре
детский: Детский
бэк: бэке
сопрячь: сопряжённая
продумать: продумать продумано
коксетереть: Коксетер
сформировать: сформировать
подсеть: подсетей подсеть
сначала: Сначала сначала
род: рода
основание: основание основании
встречаться: встречается
вступить: вступить
вуаля: вуаля
географически: географически
удаление: удалении удалению удаления удаление Удаление
рост: рост росту
слэш: слэшем
представительство: представительства
приём: приема
бердск: Бердск
юла: Юла
низина: низин низина низинах Низиной
топ: топ Топ
защититься: защититься
начинаться: начинается начинаются начинаться
креативный: креативных
двухразрядный: двухразрядное
кондратий: Кондратием
ирина: Ирина
трёхмерный: трёхмерном трёхмерные
деловой: делового деловых
слоистый: слоистая
джокер: джокеров
уложить: уложить
оповещение: оповещения
дистанционный: дистанционном
всеволод: Всеволод
сойтись: сошлись
первоначальный: первоначальному Первоначальное
кодирование: кодирования
оба: обоих обе
извлечение: извлечения извлечение
возникать: возникают возникает возникало
санкт: Санкт
отправить: отправь отправить отправлены отправлен
независимый: Независимый независимые
вводить: вводил вводят вводить
затратить: Затраченное
изделие: изделие
повлиять: повлияет
сущность: сущности сущностями сущность
подбор: Подбор
модификация: модификация модификаций модификации
обоснование: Обоснование
андроид: андроида андроид Андроида
заканчиваться: заканчивается заканчиваться
гороскоп: Гороскопы
специально: специально
передача: передачи передаче Передача передачей передачу передача
забесплатно: забесплатно
выстраивать: выстраивать
многие: Многие многие
отбросить: отброшены
уравновесить: уравновесить
процент: процент
бодров: Бодров
профилактика: профилактика
диплом: дипломов Диплом
сердце: сердцу
расшевелить: расшевелить
повышение: Повышение повышения
сравниваться: сравниваться сравниваются
портал: портала Портал
навык: навыки навык навыков Навыки навыками
прикладной: Прикладной прикладной прикладных Прикладная
администратор: администратор администратором администраторы администратора Администратор
тамбов: Тамбов
развлекаться: Развлекайтесь
попробовать: попробуем Попробуйте Попробуем попробовал попробуйте попробовать попробовали
найтись: найдется нашлось нашёлся
глава: Глава
жирный: жирный
исходный: Исходный исходного исходный исходном
форма: форма форму форме формы
повод: поводу
центр: центр центрах центра Центр
относиться: отношусь относятся относится относящиеся
префикс: префиксы префиксами
потребитель: потребителем потребитель Потребитель
достижимый: достижима
товеко: Товеко
убрать: убрать
дистрибутив: Дистрибутив
поправить: Поправлю поправил поправили поправят
задавать: задаёт задаем задает задаю задавать
заполнение: заполнении заполнения Заполнение заполнению заполнение
губить: губит
термометр: термометр термометре термометра
валеев: Валеев
чемпионат: чемпионаты
тело: тела тело телами тел
книга: книги Книги книгу Книга
музыкальный: музыкального музыкальный
отложить: отложим Отложенная
постоянный: постоянного Постоянная
выдумать: выдумаю
грубый: грубом
многоядерный: многоядерный
алексеев: Алексеев
мат: мат Мат
здешний: Здешние
пустой: пустыми пуста пустых пустые пуст пустую
действительность: действительность
забыть: забыли Забыли забыл забудьте
комментатор: Комментатор
переносчик: переносчик
возражать: Возражать
рязань: Рязань
регуляция: регуляция
цельсий: Цельсий Цельсием Цельсию Цельсии Цельсия
справедливо: справедливо
открытый: открытыми
находка: находка
уравнение: уравнений Уравнения уравнение Уравнениями уравнения
упрощение: упрощение упрощения
выталкивать: выталкивает
привычный: привычное привычном привычного
автотестировщик: Автотестировщик
показать: покажу показала покажет показано показал показали Показать покажем показать
оптимум: оптимуму оптимум
списать: списать
алиас: алиасы
поступление: поступления
посчитать: посчитать посчитанными
закончиться: закончилась закончился закончится закончатся
седьмой: Седьмая седьмого
понятный: понятное понятным понятных понятен понятны
нейросеть: нейросетей нейросети нейросетями
пермь: Пермь
участок: участок
убедиться: убедимся убедиться
гибкость: гибкостью
чтение: чтения чтение
медиана: медиана
некоммерческий: некоммерческой некоммерческого
сажать: сажать
обычно: Обычно обычно
критерий: Критерий критерии критериям критерием критерия
завести: завести
посылать: посылать
технологичный: технологичными
цель: целей целям Цель целью цель целях
внаём: внаем
маленький: Маленькая меньше маленький маленькими маленькая маленьких поменьше
утверждение: утверждения утверждение Утверждение утверждении утверждению утверждениями
исходить: исходя исходить
егор: Егор
пятно: пятно
бронировать: Бронируй
разрешить: разрешил разрешенного разрешить разрешенную
параллельно: параллельно
фамилия: фамилия
равнозначный: равнозначными
консультант: Консультантов консультантов консультант Консультант
электрод: электрод
выехать: выехал
олимпиада: олимпиада
откладывать: откладывать откладываемую
подпись: подписи подписью Подпись подпись
быстренько: быстренько
ольга: Ольга
вдруг: Вдруг
геолог: геолог
разрешение: разрешению разрешение
расчётный: расчетный
примитив: примитивы
сравнивать: Сравниваем сравниваем сравниваю сравнивать сравнивали
реляционный: реляционная реляционным
взаимодействие: взаимодействия взаимодействие
сентябрь: сентября
артикул: артикул артикула артикулы артикулов
бин: бины
голосовать: голосовать
красивый: краше красивее красивый
версионность: версионностью
наряду: наряду
грубо: грубо Грубо
бесстрашный: Бесстрашный
белорусский: белорусского
дефективный: Дефективное
навигация: навигация Навигация навигации
секрет: секретами
оркестр: оркестр
темнота: темноты
стохастический: Стохастический
пенсия: пенсию
оценка: оценка оценок оценках оценки Оценка оценке оценку
лендинг: лендингов
исчисление: исчисления исчислении исчисление
итог: итогам Итог итоге итогу
тривиальный: тривиальное
авторский: авторского авторских
оружие: оружие оружия
статический: Статический статической статический
публично: публично
ограничение: ограничение ограничений ограничении ограничениях
доступно: доступно
режим: режим режиме
зрение: зрения зрение
удалёнка: удаленке
получение: получение получением получения получению получении
розыгрыш: Розыгрыш
желать: Желаю желать желающих
расстояние: расстояния расстоянием расстояние
кодинга: кодингу кодинга
диск: Диск диском диске
нерабочий: нерабочими
осмотрительно: осмотрительно
сигнатура: сигнатуру сигнатура
накидывать: Накидываем
мониторинг: Мониторинг мониторинг мониторинга
оптовый: оптовый
бяка: бяка
кавычка: кавычками
недопустимый: недопустимые недопустимую
нажать: нажать
странный: странные странном
погодный: погодный
кодировать: кодирующее
сливать: сливаем сливать Сливаем
везде: везде Везде
секунда: секунды секунд секунда секунду
сказуемое: сказуемые
асимптотически: асимптотически
игрок: игрока игроков
исповедь: исповедь
лицензия: лицензией лицензию лицензия лицензии
казахстан: Казахстан
подзапрос: подзапросы подзапрос
когнитивный: Когнитивные
корабль: кораблей
доставка: доставки Доставка доставке доставку
обозначаться: Обозначается обозначается обозначаются
характеристика: характеристик
кольцо: кольцом кольцами
швеция: Швеции
разбитый: разбита
шаг: шагах шаг Шаг шагами шаге шагов шаги шагам
отладка: отладка отладку Отладка отладкой
программа: программ программах программы программа программе Программа программу
публиковаться: публикуются
маркетинг: Маркетинг маркетинг маркетинга маркетингу
слайд: слайде
терять: теряя
подождать: подождите Подождите
парадокс: парадокса парадокс
серьёзно: серьезно Серьезно
миф: мифов миф
мировой: мирового
понять: понять понял
лингвист: лингвист
стоградусный: стоградусная
соколов: Соколов
безвыходный: безвыходная
переписка: переписки
белина: Белин
заполняться: заполняется заполнялись заполнялось
предпринять: предпринять
кипение: кипения
писаться: писаться пишутся
непросто: непросто
заглядывать: Заглядываем заглядываем
атанасян: Атанасяна Атанасян
твёрдый: твёрдого
затрата: затраты затрат
хеш: хеш
интернет: Интернета Интернет интернет
никогда: Никогда
копаться: копаясь Копаемся
товарный: товарных товарный
школа: Школа школ Школу школы Школы школа
соображать: Соображающая
функционировать: функционируют функционирует
стробоскопический: Стробоскопические
подтип: подтипа подтипы подтипах
плечо: плечи
продолжительный: продолжительный
белобородов: Белобородов
допустить: допущенными допустить
вложить: вложенных вложенные
оператор: оператором операторов операторами Оператор операторах оператора операторы оператор
однородный: однородных
сопоставимый: сопоставимых
попасться: попалось
делиля: Делиля
нежелательно: нежелательно
каждый: каждом каждая Каждый каждым каждого каждую каждый каждое Каждая каждому
направо: Направо
технолог: Технолог технолог
принятие: принятия принятие
отображать: отображает отображающие
краеугольный: Краеугольный
непрерывно: непрерывно
магический: магическим
интерфейс: интерфейсе Интерфейс интерфейсы интерфейсом интерфейсов интерфейс Интерфейсы интерфейса интерфейсах интерфейсами
флант: Флант
нуль: нулем нулей НУЛЯ нулём нулю нуля
транспорт: транспорта
максвелл: Максвелл Максвелла
потребительский: потребительской
спрашиваться: спрашивается
кокуйкина: Кокуйкин
эксплуатация: эксплуатации
фальшивка: фальшивками фальшивку
стечение: стечению
скроллить: скроллить
разрушитель: Разрушители
разделение: разделение разделения разделении
мельком: Мельком
сильный: сильным
охрана: охрану охраны
прекрасно: прекрасно
облегчать: облегчает
ветка: ветки ветками
универсальный: универсальна
доведение: доведения доведение
тысячелетний: тысячелетний
формулировка: формулировками формулировку
присваивание: присваивание
разогнать: разгонят
тригонометрический: Тригонометрический тригонометрические Тригонометрические
моделировать: моделирует
единственный: единственный единственное единственные
казаться: кажется Кажется
организатор: организатор Организатор организатора организатором
будущее: Будущее будущего будущем будущее
вебер: вебер
вступать: вступать вступает
трифан: Трифанов
толк: толку
восток: восток
ориентировочный: ориентировочное
кроссбраузерный: Кроссбраузерная
грамм: грамм граммы
откладываться: откладываться
составлять: составляет составляют составляем составлять
гюйгенс: Гюйгенс
середина: середина середине середину
поделиться: поделитесь поделиться поделится Поделитесь
невозможно: невозможно
кубический: кубических кубические
организовать: организовано организовать
туториал: Туториал туториалами туториал
ньютон: ньютон Ньютон
коэффициент: коэффициенты
увязать: увязать
спортивный: спортивное Спортивное
индустрия: индустрией индустрии
этикет: этикет
аккуратный: аккуратный
конфиговый: конфигов
обход: обход
функционал: функционала функционал
тропический: Тропический
исследователь: исследователи
экосистема: экосистемы экосистему Экосистема экосистема
суммарный: суммарная
радиодело: Радиодело
серый: серого
профессионал: профессионалам профессионалы
поэлементный: поэлементно
пора: пор порах
начаться: началось
биржевой: Биржевых
подкрепить: подкреплён
завершение: завершения завершению завершении
приступить: приступим Приступим Приступить
неизвестный: неизвестные неизвестным
стрим: стримами Стримы
вручную: Вручную вручную
поддержка: поддержкой поддержку поддержки поддержка Поддержка
характер: характер характера характером
расположение: расположения
совместный: совместного совместную
иск: исков
бишкек: Бишкек
образовательный: образовательного образовательные образовательный
инициировать: инициировать
илона: Илона
неуместный: неуместна
общепринятый: Общепринятых
наб: наб
закономерность: закономерность
забывать: забываем забывать
вячеслав: Вячеслав
информация: информацией информации информация Информация информацию
качать: качает Качай качать
вкус: вкус
интерпретация: Интерпретация интерпретация интерпретацию
десерт: десерт
коридор: коридор
астрономический: астрономическая
проделать: проделанную проделать
прокрастинация: Прокрастинация
гость: Гости
каяться: Каюсь
взаимодействовать: взаимодействует
неисключительный: неисключительную неисключительная
мока: моки
компьютер: компьютеру компьютер
голова: голову голове
важно: важно Важно
записать: записать
лицензирование: лицензирования
запретить: запретить Запретить запрещены
жидкость: жидкости жидкость
потому: Потому
шестой: Шестая
дождь: дождей дождя
проектировщик: проектировщик
противоположность: Противоположность противоположность
постыдный: постыдное
анекдот: анекдот
ландшафт: Ландшафт
впоследствии: впоследствии
попросить: попросила попросить попросил
проблемный: проблемный проблемному
сегмент: сегментах сегменте
показаться: показалась показаться показалось Показалось
отклик: откликов отклик
отправлять: отправляет отправляем отправляйте
сверстать: сверстать
нуждаться: нуждаются нуждается
рубрикатор: рубрикатор
идентификатор: идентификатором идентификатор Идентификатор
дрий: Дриев
мануальный: Мануальный
продолжительность: продолжительность
руль: Рулю
гиря: гирь
кирилл: Кирилл
кинопоиск: Кинопоиск
паскаль: паскаль
кашап: Кашапов
освежить: Освежите
урок: урок уроки Уроки урока уроков
биржа: бирж
временной: временными
выступать: выступающее выступает выступаю
рассчитываться: рассчитывается
ясный: ясна
магнит: Магнит
студия: студия
улучшить: улучшить улучшите
характеристический: Характеристический
архитектурный: архитектурных Архитектурные
фёдоров: Федоров
чудо: чудо
принадлежать: принадлежат
контроль: контроль Контроль
отсутствие: отсутствии отсутствия отсутствие
многоуровневый: Многоуровневая
поверхность: поверхностям
звать: зовут
где: Где
отступать: отступать
выполнить: выполнены выполнена выполненных выполненным выполнить выполнили
конвенция: конвенция
оспариваться: оспаривается
пребывание: пребывания
динамичный: динамичным динамичном
вычислительный: вычислительной
аппель: Аппеля
рефакторинг: рефакторингу
1иксбета: 1ИКСБет
сеанс: сеанс
синтаксис: синтаксисом Синтаксис синтаксис синтаксиса синтаксису
вправе: вправе
переговоры: переговоров
перегрузка: перегрузка
довольный: довольны
лагранж: Лагранж
кадр: кадр кадров
безапелляционно: безапелляционно
перестать: перестанет перестанут перестало перестать перестал
черновик: черновик
равномерный: Равномерную равномерном
набраться: наберется набраться
потреблять: потребляет потребляемую
касаться: касается
ежегодный: ежегодный
продаксить: продакшен
успех: Успех успеху
осуществлять: осуществлять осуществляем осуществлял осуществляет
двигаться: двигаться двигается
коварство: коварство коварства
коммерчески: коммерчески
крайне: крайне
изготовление: изготовление изготовления
зрелость: зрелости
платёжный: платежный платёжный
просить: просим Просим прошу просили
сей: сих
склоняться: склоняется
уместно: уместно
находить: находят находить нахожу
отступ: отступы
приоритетный: приоритетными
киев: Киев
нравственность: нравственность
скопировать: Скопировать скопировать скопировали
достоинство: достоинства достоинствам
удивлять: Удивляют
одноимённый: одноименный одноимённый
стратегия: Стратегия стратегий стратегию стратегии
вещь: вещей вещах
введение: Введение введение
хабраблог: хабраблог Хабраблоге
сноска: сносок
специфика: специфики
генерировать: генерирует генерируем генерировать
форматировать: форматировать
иннополис: Иннополис
чӑваидти: Чӑвашла
житель: жителей
указание: указанием указание
освещение: освещения
готовить: готовим
докопаться: докопались
продакшен: продакшене
поверить: поверить поверите поверили
затруднение: затруднение затруднения
тонкость: Тонкость
положить: положено положить
эффективность: эффективности эффективность
ночью: ночью
пояснение: пояснения пояснении пояснений
любить: люблю любит
корректно: корректно
динамический: динамического Динамическое динамических
проходиться: прохожусь
ранее: ранее
пересмотреть: пересмотреть пересмотрено
готический: готический готическая
придумывать: придумывать придумывал
картошка: картошка картошки картошку
интересовать: интересуют интересует
ресурсный: ресурсный
состояние: состоянии состояния состояние состояниях Состояние Состояния
баланс: баланса
сократить: сократить
править: Править править
скалярный: скалярному Скалярное скалярное
нужно: Нужно нужно
зарегистрироваться: Зарегистрируйтесь Зарегистрироваться зарегистрировалось
вольт: вольт
руководствоваться: руководствоваться
блокирование: блокирование
оттуда: оттуда
выходной: выходное выходных выходные
перспектива: перспективе перспективу перспективах
коза: коз коза
институт: институты
отозвать: отозвать отозвано
тестконтейнер: тестконтейнерам
срабатывать: срабатывать
явно: явно
заявка: заявку
отождествлять: отождествляют
доказать: Докажем доказать доказали
нарративный: Нарративный
исправление: исправлению исправлением исправления исправлений
перевозчик: перевозчик
соответствующий: соответствующими
серьёзный: серьезные серьёзная
калифорния: Калифорния Калифорнии
узкий: узкой
прилететь: прилетело
новость: Новости новостями новостей новости
долго: долго
дееспособный: дееспособное
существо: существу
неправильно: неправильно
заработать: заработанных заработать
многообразие: многообразие
поисковый: Поисковая поисковый поисковые поисковую
умирать: умирает
мечтать: Мечтает
основный: Основная основную основными основная
итерация: итерацию итераций итерации
аббревиатура: аббревиатур аббревиатура
поднимать: поднимает Поднимаем
скоро: Скоро скоро
частично: частично
правительство: Правительством Правительства
взыскание: взыскания
пятёрка: пятёрку
скриптолог: скриптолог
пытаться: пытаемся пытался пытаются Пытаемся пытается
сечение: сечения
разрабатывать: разрабатывать Разрабатываю разрабатывающая Разрабатываем
набрать: набрать наберут
кликнуть: кликнем
тверь: Тверь
иван: Иван
бывалый: бывалые
компоновщик: Компоновщик
обсудить: обсудим обсудить
сохраняться: сохраняется сохраняются сохранялась
комплексный: комплексной комплексных
пронестись: пронеслись
особенность: особенностях особенностей
нацелить: нацеленным нацелены
адвокат: адвокатов
дорого: дорого
баловаться: балуюсь
соответсвие: соответсвие
фонд: Фонд фонд
одновременно: одновременно
офис: офиса офис офисы
новогодний: Новогоднее
строгий: строгое строгой строгого
помощник: Помощник помощников помощник помощника помощником
стадия: стадии
марин: Маринов
операнд: операнд
лоб: лоб
ботаник: ботаник
мыслить: мыслить
архив: архив архиве Архив
носитель: носителях
тестировщик: тестировщик тестировщикам тестировщики тестировщиков Тестировщик
понадобиться: понадобились понадобится понадобиться
строчка: строчке
абонемент: абонементов
активность: Активности Активность
почтовый: почтовый почтовых
экспорт: экспорт экспорта
митап: митапов
покрывать: покрывает покрывают
гормон: гормоны
изучение: изучения изучении изучение Изучения изучению
несанкционированный: несанкционированном несанкционированно несанкционированного
грааль: грааля
мухов: Мухов
устанавливать: устанавливает устанавливаете Устанавливаем устанавливаем устанавливать
чернухина: Чернухин
удовлетворять: удовлетворяет удовлетворяют удовлетворять
объединять: объединяет объединяют
спускаться: спускаться
сравнение: сравнение сравнению сравнения сравнении
линный: Линней
заблуждение: заблуждение заблуждений
выявить: выявить
охватывать: охватывает
криволинейный: Криволинейный
сайентист: сайентисты
компас: компаса
инфраструктура: инфраструктуры Инфраструктура инфраструктуру
токсичный: токсичных
триединый: Триединый
недостоверный: недостоверна
изъятие: изъятиями изъятий
достоверность: достоверности
что: чему чём
развернуть: развернуть развернутый развернута Развернём
максимально: максимально
сочетание: сочетание
интеграционный: Интеграционное интеграционных интеграционные
изоморфный: изоморфны
разложить: разложил разложить
вино: вина
тарифный: тарифный
виктор: Виктор
сублимация: Сублимация
отправка: отправки
стандарт: стандарты стандартах стандарту
негде: негде
ухудшать: ухудшает
отписка: отписки отписку отписке
квадратурный: квадратурные
галерея: галерею
севастополь: Севастополь
петербург: Петербурга Петербург
логично: логично
подынтегральный: подынтегральная Подынтегральная
волков: волков Волков
стоять: стоял
перезапускать: перезапускаем
защитник: Защитник
подверженный: подверженные
уничтожение: уничтожение
крутый: Крутейшая
парсер: парсер парсеры
небо: небо
параметризовать: параметризованы
тест: тестами теста тестах Тесты тест тесты тесте Тестами тестов
инициализировать: инициализированы инициализировать
функциональность: функциональности
нытьё: нытьем
сосредоточить: сосредоточить
фенкс: Фенкс
пособие: пособие
типографика: Типографика
коллега: коллегами коллеги коллегам коллег
гибкий: гибче гибким
высыпать: высыпана
перебирать: перебирать перебираем
методология: методология методологии
учить: учить учили
мажуга: Мажуга
полезно: полезно
запрашиваться: запрашиваются
стрелочка: стрелочку
фабрика: фабрики фабрика
изящно: изящно
намекать: намекали
присвоение: присвоением
нереально: нереально
накладываться: накладываются
зум: зума
случай: случаи случае Случай случаев случай случая случаях
дочерний: дочерние дочерний
обеспечивать: обеспечивает
небезопасный: небезопасное
оформлять: оформлять
жить: жила живут живёт
улица: улице улица
идентифицировать: идентифицировать
обмениваться: обмениваться
реагировать: реагировать
достижение: достижениях достижения
систематизировать: систематизирует
залить: зальем
волос: волос
глупо: глупо
студенческий: студенческая
затопить: затоплен
теорема: теореме теоремы
индивидуально: индивидуально
ритейл: ритейла
конкретика: конкретики конкретикой
декоратор: Декоратор
ситидрайв: Ситидрайв
чуть: Чуть
административно: административно
лицо: лиц Лицам лицам лицами
начальный: начальная начальному
индивидуальный: индивидуальный индивидуальное индивидуального
решаться: решаются решается
покупать: покупают покупать
факт: факт фактах факту факте фактов
планковский: Планковская
ухо: уши
проиллюстрировать: Проиллюстрируем
коснуться: коснуться
шаров: Шаров
подобраться: подобрались
направлять: направляющий
клетка: клеток клетками клетка
неравномерный: неравномерное
коммивояжёр: коммивояжёр
становиться: становится
искусство: искусство Искусство
логарифмический: Логарифмические
решать: Решаем решал решаем решаете решать решает
расовый: расовому
обладатель: обладатели обладателем
килобайт: килобайт
порча: порчу
старичок: старичка старичке
длительность: длительность
открывать: открывает Открываем Открывают открываем открывать
опросник: опросник
ещё: Ещё Еще ещё
сопровождение: сопровождению сопровождение сопровождения
тетраэдр: тетраэдра
век: веке
квартал: кварталов
втб: ВТБ
многое: многое
рассуждать: рассуждать рассуждал рассуждаешь
оформление: Оформление
четвёртый: четвертый Четвертая
привязать: привязать привязан
производитель: производителя производитель Производитель
условный: условных условные
пропадать: пропадать
корректор: корректор Корректор
дедушка: дедушки
варьироваться: варьировалась варьируется варьироваться
подходящий: подходящую
логистика: логистики
пофикситься: пофиксится
кастить: кастить
причинять: причинять
потребоваться: потребуется потребоваться
впечатление: впечатление
океея: Окееей
укрытие: укрытий
весьма: весьма
малевать: малюют
скастить: скастить
расчёт: расчётов расчетах
юморист: юмористы
стесняться: стесняться стесняйтесь
лампа: лампой
никакой: никаких никакой
стажёр: стажер Стажёр Стажер
автоматический: автоматическом автоматического Автоматическая
продвижение: продвижения
аксиальный: Аксиальный
приравнять: приравнено
весы: весам весах весы
свет: света
интроверт: Интроверта
македонски: Македонски
объявление: объявления объявлений
читатель: читателя
гордиться: горжусь
быстродействие: быстродействие
дожимать: дожимать
бушман: Бушмана
обезличить: обезличенные обезличенном
старожил: Старожил
распарсить: Распарсить
сравняться: сравняются
причесать: причесать
достаточный: достаточных
граничить: граничит граничат
вычесть: вычесть
продажа: продажам продаж продажи
камень: камней камень камни
искажение: искажения
белиз: Белиза
разбиваться: разбивается разбиваются
обменный: обменный
уменьшение: уменьшения
разность: разность
вплоть: вплоть
нововведение: нововведения
мороз: Мороза
минимализм: минимализм
оракл: Ораклом ораклом оракла
слежка: слежка
демон: демон
распределённый: распределенную
спектр: спектр
старт: старт
шахматный: шахматном
выдерживаться: выдерживается
неглупый: неглупый
дискриминант: дискриминант
натуральный: натуральному натуральное
своевременность: своевременностью
замешательство: замешательство
разоблачение: разоблачением разоблачение
голосование: Голосование
объяснять: объяснять
оферта: Оферта
полезность: полезности
смерть: смерти
свидание: свидания
предприятие: предприятия предприятием
половинка: половинка половинок
петров: Петровым
официально: Официально
лидогенерация: Лидогенерация
чувак: Чувак
слёрма: Слёрм
тупик: тупик
примитивный: примитивный
подобрать: подобрать
шесть: шесть
художник: Художник
кладезь: кладезь
заметка: Заметка заметку заметки
поменяться: поменялся
учитываться: учитываются
взвешивать: взвешивал взвешивать
цеттелькастный: цеттелькастен
милый: милые
опциональный: опциональный
многоязычный: многоязычное
катать: катал
реквизит: Реквизиты
ненадлежащий: ненадлежащего
особо: особо
переложить: переложить
половинаотрезка: половинаОтрезка
преемник: преемник
классно: классно
викиучебник: Викиучебник викиучебник
модель: модель моделью моделей Модель
прокидывать: прокидывая прокидывать
отработать: отработает
принести: принесет
нескромный: Нескромная
радовать: радовать
исполнитель: исполнитель
останавливать: Останавливаем
выворачивание: выворачивание
иванькина: Иванькин
замолвить: замолвите
трудный: Трудная
алексей: Алексей
цензура: цензурой
бояться: бояться
этнический: этническому
известно: Известно известно
позвать: позвали
узнать: узнать Узнать
посылка: посылок
подписываться: подписываются
подставиться: подставится
уменьшаться: уменьшаться
выгорание: Выгорание выгорания
традиционный: традиционном
сеновал: сеновале
реестр: реестр реестра
толстоватый: толстоват
избыточный: избыточна
аналитический: Аналитическая аналитических
закрепление: закрепления
позиция: позиция позициях
опускать: опускаем Опускаю
выделение: Выделение
традиционно: Традиционно
градиент: градиента
ранний: Раньше раньше
спасение: спасение
исключить: исключите исключить
цвет: цвета цвет цветов
классификация: классификации
картина: картину
перечень: перечень Перечень
европа: Европы
млрд: млрд
закинуть: закинем
овечкин: Овечкин
я: Меня Мне мной
техника: Техник техники
инвариантный: инвариантны Инвариантный
россельхозбанк: Россельхозбанк
чепец: Чепцов
занять: занял занять
вовсе: вовсе
область: области областях область
раскраска: раскраску Раскраска
каргокульт: КаргоКульт
подтянуть: подтянуть
внимание: внимания вниманию внимание
благо: блага
квадратный: квадратного квадратными
отличать: отличать
доменный: доменный доменной
постараться: Постараюсь постараюсь постараемся
флешка: флешке
подсчёт: подсчета Подсчёт
отличаться: отличаться отличаются отличается
креативность: креативность креативностью
короткий: короткий короткое
томск: Томск
угрожать: угрожаете
фронтенд: фронтенда Фронтенд фронтенду
диаграмма: Диаграмма диаграммы диаграмму диаграмме Диаграммы
сравнительно: сравнительно
самостоятельный: самостоятельное самостоятельном
снижать: снижает
крайний: крайних крайнем крайней
улика: улик
внутренний: внутреннего внутренними внутренних внутренний внутреннем
чеканиться: чеканились
резко: резко
внедрение: внедрению внедрении Внедрение
акция: акциями
повреждение: повреждения
подставляться: подставляются подставляться
люмен: люмен
васин: Васин
орган: органа органу
февраль: февраля
исправиться: исправиться
бэкенд: бэкенда Бэкенд бэкенд
скачать: скачать Скачать
исключаться: исключается
вставлять: вставлять вставляемый
октябрь: октября
пробовать: Пробуем пробовал пробуют пробуем
подсистема: подсистемой
сертификационный: сертификационном
страхование: Страхование
друг: друзей друзьями друга друг другу
компонент: компонента компонентов компонент компонентами
радиан: радиан
зависимый: зависимых
робототехника: робототехники
неоднозначный: неоднозначен неоднозначные
иначе: Иначе иначе
отчасти: Отчасти
рекомендательный: рекомендательных рекомендательным
коленка: коленке
напоследок: Напоследок
шоковый: Шоковое
кук: куки
вампир: вампиров
законопроект: законопроект
выступление: выступлению
кусок: куски
складывать: складываем
рассматриваться: рассматривается рассматриваются
помещаться: помещается
компилировать: компилировать компилируем
тайный: Тайное
восстановить: восстановлены
отбираться: отбирались
торговый: торговых
радужный: Радужный
проведение: проведения Проведение
качест: качесте
убыток: убытки убытков
лидер: лидеров лидер
чужой: чужих
неплохо: неплохо
витебск: Витебск
накладывать: накладывать
абонентский: абонентскому
болезнь: болезни
хозяйство: хозяйстве хозяйство
технологический: технологический технологические технологических
оказание: Оказание оказания оказании
качественный: качественный
почему: Почему почему
трудозатратный: трудозатратно
многочлен: многочлен
сложение: сложения Сложение
устранить: устранить устранены
исследуться: исследуется
выродиться: выродится
ютуба: Ютуб ютуба
поставка: поставок
нюанс: нюансы
обнаружение: обнаружения
представлять: представляющий представляют представлять представляли представляем представляет
подобный: подобные подобном подобное подобная подобных
сгенерировать: сгенерированный Сгенерируй сгенерировать
элементарно: Элементарно
продавать: продавать
испытание: испытаний
долг: долга
дискриминация: дискриминацию
вакуум: вакууме
корыто: Корыто
стерлитамак: Стерлитамак
елабуга: Елабуга
программно: программно
переливаться: переливаться
просыпаться: просыпается
кубик: кубиков
длинный: длинное длинную
снизить: снизить
шикарный: Шикарная
термин: термином термин терминов термина термины
хранилище: хранилища
аксиомовец: аксиомовцы
тарашкевіца: тарашкевіца
присылать: присылайте Присылать
наглядно: наглядно
родниться: роднимся
смоленск: Смоленск
вынести: вынесены
репутация: репутация
устроенный: устроен
аламбер: Аламбер
владыкин: Владыкиным
предок: предков предка
луна: луны
склеивать: склеиваем
стоить: стою стоило Стойте
удостоверить: удостоверенные
дайсон: Дайсона
необитаемый: необитаемом
массово: массово
август: августа
апдейт: Апдейты апдейта
типичный: Типичный типичная
однозначный: однозначного
котёс: Котеса
останов: останова
эмулятор: Эмулятор эмуляторе
канонический: канонический
напоминать: напоминает
смекалка: смекалку
поиграть: поиграть
рекомендоваться: рекомендуется
облачный: Облачные облачные
копирайтер: копирайтер Копирайтер
унифицировать: унифицировали
бесконечномерный: бесконечномерные
перевесить: перевесила
гик: гиков
ограничить: ограничить ограничена ограничен
смысл: смысле смысл смысла
воля: волей
надпись: надпись
текстура: текстуру
переживать: переживайте переживать
поговорить: поговорить
встать: встал
поступить: Поступим Поступили поступим
лично: лично
прижиться: прижилась
европлан: Европлан
метка: метками метка
дебажить: дебажить
прогореть: прогорел
инвестиция: Инвестиции
площадка: площадке площадками
бруклинский: Бруклинский
спектральный: Спектральное спектральный
кластер: кластер кластера
евгений: Евгений
парадигма: парадигм
български: Български
выяснить: выяснить выяснили
платёж: платежей
сюда: сюда Сюда
выбор: Выбор выбору выбором выборе выбора выбор
смутьян: смутьяна
импортозамещение: импортозамещения импортозамещение
публичный: публичный публичное публичного
конь: коне
замерзание: замерзания
маска: Маска
закономерно: закономерно
осознать: осознает
куча: кучу куча
откатить: откатить
стипендия: стипендию
переносить: переносить
национальный: национальном
достойный: Достойные
снг: СНГ
цыпкина: Цыпкин
подбегать: подбегал
предприниматель: предприниматель предпринимателя
большинство: большинстве Большинство большинства большинство
оптика: оптика
удостоверять: удостоверяющие
владеть: владеете владеть
четверг: четвергам
скостить: скостить
выдерживать: выдерживать
утвердить: утверждённом Утверждено
брак: брака
съесть: съедено
расти: расти растет растущих растёт
гаусс: Гаусса
кулон: кулон
прочий: прочих прочие Прочие
чашечный: чашечные
утирать: утирал
стратегический: стратегическому стратегическое Стратегический Стратегическое
рф: РФ рф
прародитель: прародитель прародителя
подсказка: подсказки
рассмотрение: рассмотрению
попадаться: попадалась
языковой: языковая
чреватый: чреват
разговор: разговора разговор
каков: каков
неверно: неверно
эрмитовый: Эрмитово
более: Более
подготовить: подготовил
аппарат: аппаратах
кой: кое
апрель: апреля
подправить: подправить
фрагмент: Фрагмент
государство: Государство государства
простить: Простите
вагончик: вагончик
кош: Коши
присоединение: присоединении Присоединение присоединение
сбер: Сбер
пёсик: пёсиков
подвергаться: подвергается
отслеживать: отслеживать Отслеживать
точно: точно Точно
рыночный: Рыночные
поместить: поместить
звук: звуков звука звуки
крошечный: крошечная
сублицензирование: сублицензирование
период: периода период
неправомерно: неправомерно
исполнять: исполнять
энтропия: Энтропия
поделить: поделить
дуализм: дуализма
компиляция: компиляция компиляции
проглядеть: проглядел
брянск: Брянск
усреднение: усреднение
равновесие: равновесии
потуга: потуги
состязание: состязание
шаблон_проектирование: шаблон_проектирования
медиапроект: медиапроектов
екатеринбург: Екатеринбург
инвестблок: ИнвестБлоке
регистр: регистр
девяностый: девяностых
территория: территории
единственно: Единственно
упаковка: упаковки
борель: Бореля
механический: механическим Механическая
назвать: назван назвать названные назвали назвал Названо
есппа: ЕСПП
университет: университета университетов Университет
происхождение: происхождение
посетитель: посетителей Посетитель
направляться: направляемся
глаз: глазами глаза глаз
влияние: влияние влияния
выполниться: выполнится
демонстрировать: демонстрирует
широко: широко
предупреждение: предупреждение
мероприятие: мероприятий мероприятиях
подсунуть: подсунуть
непрямой: непрямую
сломать: сломаем Сломать сломать
лагранжев: лагранжевом
прогресс: Прогресс
фундаментальный: Фундаментальные
особенно: особенно
удержание: удержания
микрофон: микрофон
полноправный: полноправные полноправный
плис: плис
подсказать: подсказать
соединение: соединение соединений
двусмысленный: двусмысленными
смело: Смело
обновляться: обновлялись
холдинг: Холдинг
таяние: таяния
снизу: снизу
подтверждение: подтверждением подтверждения
экранировать: экранировать
реорганизовать: реорганизовать
фронтиспис: фронтисписа
транзакция: транзакция транзакцию
погрешность: погрешность Погрешность
недействительный: недействительными
открыть: открыв открыть Открыть открыла
лаплас: Лапласа
репликация: репликацию
гибнуть: ГиБ
признаваться: признается признаются
українська: Українська
треугольник: треугольников
мапиться: мапиться
продаться: продался
оформить: оформить
уменьшить: уменьшить
ремесло: ремесло
иррациональный: Иррациональные
капот: капотом
практикум: практикум Практикум
окак: Окак
двухтысячный: двухтысячных
транспортный: транспортных Транспортную
задействовать: задействовать задействовали
браузер: браузере браузер Браузер браузера
жизненный: жизненным
миддло: миддлу
нотификация: нотификациям
интуитивно: Интуитивно интуитивно
статистика: Статистика статистики статистика
повлечь: повлечь
чёрный: черные чёрной
переименовать: переименуем переименованными переименовано
пролистать: Пролистав
менеджер: менеджером менеджер менеджеры Менеджер
стив: Стив
самара: Самара
аффинный: Аффинное
делегировать: делегировать делегируйте
правильно: правильно Правильно
выгореть: выгори
произведение: произведение произведением произведению
панель: панелей панель панелью
повисеть: повисит
забрать: заберёт
разносторонний: разносторонние
брокерский: брокерское
питон: питоне
сборщик: сборщик
зеленодольск: Зеленодольск
копирайтинг: Копирайтинг копирайтинг
тут: Тут
подходить: подходит
дойти: дойдем
соцсеть: соцсетях
гибридный: гибридных
импульс: Импульс
разделяться: разделяются
клавдия: Клавдия
сравнить: Сравнить сравнить Сравните
яблоко: Яблоко
защитный: защитный
персонал: персоналу
рексофт: Рексофт
масса: массы Масса
партиционирование: партиционирования
совершенство: совершенству
трансляция: трансляция
оказывать: оказывает оказывающая
совершенствоваться: совершенствовался
зачем: Зачем
баттл: баттлы
аэрокосмический: аэрокосмического
появление: появления
сеттер: Сеттер
прямой: Прямая прямые
астана: Астана
агрегатор: агрегатор агрегатора
оно: Оно оно
вебсокет: вебсокета вебсокетов вебсокетах
справляться: справляются
подталкивать: подталкивать
полностью: полностью
задачник: Задачник
рядом: Рядом рядом
гибко: гибко
обязательство: обязательств обязательство
остров: остров острове острову Островов
мультфильм: Мультфильм
появляться: появляются появлялись
готовиться: готовился
телеграмма: Телеграмм
уверить: уверены
рубеж: рубеж
счастие: счастью счастья
обойтись: обошлось обойтись
односторонний: одностороннем
логичный: логичным
жестокость: жестокость
юг: Юг юг
кредитный: Кредитный
любовь: любовью
делитель: делители
грейтцер: Грейтцер
лейденский: Лейденская
содействовать: содействовать
воспроизводить: воспроизводить
автоматически: автоматически
нечётный: нечётное
помещать: помещать
несерьёзно: несерьезно
подпоследовательность: подпоследовательностей
листик: листике
интересно: Интересно интересно
грузовой: грузовых
сим: Сима
бонус: Бонус Бонусов
избавиться: избавится
анимация: анимации
виртуальный: виртуальные виртуальную виртуальная
присоединяться: Присоединяйся Присоединяйтесь
передавать: передавая передавать передает
угадывать: угадываем угадывать
жордан: Жордана
континент: Континент
эйлер: Эйлера
суд: суде суда
ускорять: Ускоряем ускоряем
последовательный: последовательных последовательное последовательного
расписание: Расписание
связывать: связывают
кризис: кризис
подбирать: подбираем подбирает
говориться: говорилось
разговаривать: Разговариваем
мельников: Мельников
ангарск: Ангарск
летний: летним
крыло: Крылья
прототипирование: Прототипирование
автомаршрутизация: автомаршрутизацию
танец: танцам
накапливаться: накапливается
120мба: 120мб
каталанский: каталанская
продавец: Продавца продавец продавцом
деталь: деталей деталь
подаваться: подается
обёртка: обертку обертки
коммуникационный: Коммуникационный
барнаул: Барнаул
профсофт: ПрофСофт
занимать: занимают
релиз: релизов релиз
рассылка: рассылку рассылки
оптимальный: оптимальном оптимальная оптимального оптимальнее
артём: Артём
лаборатория: Лаборатория
лучик: лучик
занавес: Занавес
молоцить: Молоцило
николай: Николай
бросать: бросать
литр: литр
обработать: Обработать
джон: Джон
импортировать: импортировать
алфавит: алфавит алфавита алфавиту
выгрузиться: ВЫГРУЗИТСЯ
сливаться: сливаются
дёргать: дергать
веселовский: Веселовская
бауман: Баумана
безвозмездно: безвозмездно
котлин: Котлин
долететь: долететь
запилить: запилить
есть: Есть
уложиться: уложился
пользоваться: пользуются пользоваться пользуется
взвесить: взвесить
круглый: круглый
проактивность: Проактивность
шкала: шкалу Шкалы Шкала шкалы шкал шкала шкалой
нарушиться: нарушится
борьба: борьбы
поспорить: поспоришь
претендовать: претендует
сильно: сильно
консоль: консоль консоли
фабричный: фабричный Фабричный
повторять: Повторяем повторять повторяем
жесть: Жесть
менее: менее
алгоритмический: алгоритмическое
исполнительный: исполнительной
файловый: файловой
тэг: тэгов
досуг: Досуг
финтех: финтех
вписать: вписать
пропагандировать: пропагандирует
орфография: орфографии
арифметик: арифметику
перегружёный: перегруженые
столкнуться: столкнулись столкнулся
материя: материях материи
умереть: умрет
ловушка: ловушку Ловушки
тестер: тестер
отдать: отдать
биллинга: биллинга
анна: Анна
аутсорсинговый: Аутсорсинговая
определённый: определенную определенная
выпускать: Выпускающий
выплата: выплате
медиатор: Медиатор
спб: СПб
воспроизвестись: воспроизведется
доктрина: доктриной
включение: включений
статика: статика
риск: рисками риски риск
банковский: банковских
ранг: ранга
применимость: применимость
документация: документации документация документацию
отличить: отличить
приходиться: приходится приходилось
засыпать: засыпает
майкоп: Майкоп
дубликат: дубликатов
новороссийск: Новороссийск
гук: Гука
слепить: слеплены
справочник: справочник Справочник
движение: движение Движение движения
настраивать: Настраиваем настраивает настраиваем настраивать
оригинал: оригиналом
башня: Башни
подчеркнуть: подчеркнуть
визуализация: Визуализация визуализация
европейский: европейских
декомпиляция: декомпиляция
доверять: доверяют
построитель: Построитель
пятый: Пятая
договориться: договориться договорились
пожелание: пожелания
прайс: Прайс
минпромторг: Минпромторгу
линковаться: линкуются
обращение: Обращения
нематериальный: нематериальные
приход: прихода
логотип: логотипов
дважды: дважды
установление: установления
решиться: решились
счётный: счётный
трекер: Трекер
встраивать: Встраиваемая
прошествие: прошествии
математика: математике Математики математики математикой
арифметический: арифметические арифметических
закон: закон законов Закон
тюмень: Тюмень
совместимый: совместимых
называться: называться называются называется
патч: патчи патчах
сортировать: сортированный
хватить: хватит
овзяк: Овзяк
частичный: Частичная
студент: студентов студентам студенты
приходить: приходят приходит
ориентация: ориентацию
дифференциал: Дифференциал
псевдоним: псевдонима
заказной: Заказная
цитировать: Цитировать
ортогональный: Ортогональный
защитить: Защищено
нецелесообразный: нецелесообразным
пачкать: пачкать
высококвалифицированный: высококвалифицированных
псевдоскалярный: Псевдоскалярное
округляться: округляется
абзац: абзаце
поведенческий: Поведенческие поведенческий
скрининг: скрининг
рубль: рубль рублей
человеческий: человеческой человеческого
эндпоинта: эндпоинта
дойник: Дойников
подряд: подряд
нефункциональный: нефункциональные
обработчик: обработчика
ака: ака
неограниченный: неограниченному
производительный: производительный
одобрение: одобрением одобрения
рамка: рамках рамки
поворот: поворота
конфигурация: конфигурацию конфигурация
формализм: Формализм формализм формализме
входящий: входящими
альфа: Альфа
ловко: ловко
структурированный: структурированно
инжиниринг: инжиниринга инжиниринг
приоритет: Приоритет
напороться: напороться
тогда: Тогда
гамильтон: Гамильтона
чебоксары: Чебоксары
таргетировать: Таргетированная
упростить: упростить
древо: древо
усложняться: усложняться
убежать: убежали
кострома: Кострома
неоднократный: неоднократное
коллизия: коллизий
трекинг: трекинг
сессия: сессию
казань: Казань
данные: данных Данным данным данными
робот: роботам робот роботов
соискатель: соискателя
ожидание: ожиданиям
железо: железу
разъяснять: разъясняет
многопрофильный: многопрофильная Многопрофильная
электроника: электроники
гиперболический: гиперболические Гиперболические
бюджетирование: бюджетирования
валидный: валидная
плавление: плавления
светодиод: светодиодом
яндекс: Яндекса Яндекс
асимптотика: асимптотикой
динамически: динамически
привилегия: привилегий
развить: развить
прикреплять: прикреплять
фиолетовый: Фиолетовая
проводиться: проводился проводится
логически: логически
заместитель: Заместитель
собственность: собственность собственности
анонс: Анонс
печатный: печатных
освободиться: освободится
перерегистрироваться: перерегистрируются
народный: народного
уточнить: уточнить
модератор: модераторам Модератор
вправо: Вправо
соблюдать: соблюдать
репа: репе репу
киров: Киров
судьба: судьба
племя: племени
разнообразие: разнообразия
карл: Карл
несправедливость: несправедливость
ратэк: РАТЭК
профилактический: профилактическими
весна: весной
одноклассник: Одноклассники
авив: Авив
адаптация: адаптация
гамма: Гамма
отстоять: отстоять
далеко: далеко
очистка: Очистка
маяк: Маяк
смеяться: Смеяться
отобрать: Отобранный
силовой: силовые
хабра: Хабре Хабр Хабру
дефолт: дефолта
телематика: ТЕЛЕМАТИКА
просмотреть: просмотренное
север: север
поддержание: поддержанию
шина: шине
фигура: фигуры фигуру фигур
измерять: измерять
ценный: ценное
противоречить: противоречить противоречит
телефонный: телефонный
выручать: выручает
распространять: распространяемая распространять
пенза: Пензе Пенза
отсюда: Отсюда отсюда
электроэнергетика: электроэнергетике
законодательство: законодательству законодательство законодательства законодательством
обогатить: обогатило
леонид: Леонид
неиссякаемый: неиссякаемый
уважение: уваженьем
фотография: фотография фотографию фотографий
тэк: ТЭК
тёма: Тёма
прыжок: прыжок
раздел: разделах раздел Разделы разделы разделе
обязанность: обязанность обязанностей
копировать: копировать копируем копирует
воркшоп: воркшопы
фундамент: фундамента
гертовский: Гертовская
бэкап: бэкапу
пересобрать: пересобрать
никуда: никуда
модифицировать: модифицировать
возврат: возврат возврата
трюк: трюк
фраза: фраза Фраза
изоморфизм: изоморфизма
косинус: косинус Косинус
текущий: Текущая текущую
фея: феями
приводиться: приводится
ход: ХОДОМ ходе
гомель: Гомель
возлагаться: возлагается
рендерить: рендерить
переучиваться: переучиваться
отрасль: отрасли
сожаление: сожалению
нотация: нотациях
ковариантный: Ковариантный
мария: Мария
активный: Активный активных
график: график графиком
нияз: Нияз
сервисный: сервисных
специфичный: специфичные специфичный
цупис: ЦУПИС цупис
нейман: Неймана
выжимка: Выжимка
кратность: кратность
орда: ОРД
зайти: зайти
разрешаться: разрешаются разрешается
проектировать: проектировать
подсчитать: подсчитать
скриншот: Скриншот скриншота скриншот
рационально: рационально
фаренгейт: Фаренгейта Фаренгейты
вчера: вчера
двояко: двояко
небесный: Небесная
прикручивать: прикручивали
запятая: запятую запятой
ориентир: ориентир
профильный: профильным
подумать: подумал подумать
нода: ноду
электронщик: Электронщик электронщиком
вологда: Вологда
отрезание: отрезания
уделить: уделить
трек: трека
обзор: обзор Обзор
оренбург: Оренбург
постановка: Постановка
восьмой: Восьмая
там: Там
боец: бойца
геймификация: геймификация
ускорить: ускорить
хост: хост Хостов
селектор: селекторам
гравитация: гравитацию
сексуальный: сексуального
бой: бою
итого: итого Итого
превосходить: превосходит
особый: особое
стрелка: стрелка
современник: современники
регулярный: регулярного
целиком: целиком
подгружаться: подгружаться
округлить: округленное
браться: берутся
отыскать: отыскать
арифмометр: арифмометр
паблишинг: Паблишинг
собирательный: Собирательный
ориентировать: ориентирована
оскорблять: оскорбляет
симферополь: Симферополь
цикличный: цикличны
мета: мета
перевес: перевесом
дочка: дочка
регулироваться: регулируется
конвертер: Конвертер
сопоставляться: сопоставляется
подробно: подробно
очевидный: очевидное очевидным Очевидный очевидные
ереван: Ереван
формировать: формирует
юрий: Юрий
придать: придал
безусловный: безусловным
саранск: Саранск
попахивать: попахивает
закрывать: закрывать
продукция: продукции
осваивать: осваиваю
соблазнение: соблазнении соблазнение
нагромождение: нагромождении
оригинальный: оригинальной
адекватный: Адекватная
память: памяти памятью память
совершать: совершать
испытать: испытать
атомный: атомная
встроить: встроенном встроенный
раздумывать: раздумываете
гонорар: гонораров
видеолекция: видеолекциями
ревить: ревью
ньютоновский: Ньютоновская
терминология: Терминология
перевернуть: перевернул перевёрнутом
новенький: новеньком новенький
кульман: кульмана
евангелист: Евангелист
контракт: контракт
подборка: подборка
внутрь: внутрь
планирование: планирование Планирование
сконвертировать: сконвертировать
оверинжиринг: оверинжиринга
орбита: орбиты
наедине: наедине
метавселенная: метавселенную
допустимый: допустимые
высокоуровневый: Высокоуровневый
живой: живые
предоставляться: предоставляться предоставляется
совокупность: совокупность
нумерология: нумерология
отраслевой: отраслевым
откалибровать: откалибровать
редкий: реже
переводчик: Переводчик переводчик
нарочно: нарочно
многочисленный: многочислен
разновидность: разновидность
индукция: индукция
площадь: площадь площади площадей
мост: Мост мост
перекладывать: перекладывая
библиотечный: библиотечные
преподаватель: преподавателей
таковой: таковых такового таковыми
графический: Графический графические
прямоугольник: прямоугольников
фок: Фока
замерить: Замерьте
новокузнецк: Новокузнецк
добровольный: добровольное
вычисляться: вычисляется
даниэль: Даниэля
закрыть: Закрыть
конструктор: конструктором
фон: фона
сельхозинновация: сельхозинноваций
признак: признакам
скопиться: скопившуюся
культура: культурой
преамбула: преамбуле
всеобщий: всеобщего
приватный: приватный приватных
изотропный: Изотропный
стерадиан: стерадиан
нормализовать: Нормализовать
прогулка: прогулка
послать: послать
отвечать: отвечающий отвечает Отвечайте
отражать: отражает
стресс: стресс
снимок: снимка снимков
медиапланирование: Медиапланирование
синий: синяя синем
хабратариф: хабратариф
выбросить: выбросить
изя: Изи
метр: метр
теслить: Тесля
импортозаместить: импортозаместить
наискосок: наискосок
драга: драг
издательский: Издательский
арсений: Арсений
дедупликация: дедупликация
посвятить: посвящено
светодиодный: светодиодную
замечательный: замечательно замечательный Замечательный
повторный: Повторная
добросовестно: добросовестно
тусовка: тусовки
слушать: слушать
предположительно: предположительно
захотеть: захотел захотим
подвох: подвох
шустрый: шустрее
ализар: Ализар
изложить: изложенных
возместить: возместить
донат: Донаты
новосибирский: Новосибирская
колоночный: колоночными
неумение: неумение
ситниковый: Ситников
вряд: вряд
усилие: усилия усилий
строго: Строго строго
сбпэя: СБПэй
василий: Василий
удобно: удобно
затрудняться: Затрудняюсь
неимущественный: неимущественные неимущественных
касперский: Касперского
вещество: веществ
портировать: портировать
азот: азота
бета: Бета
сезон: сезон сезона
баннер: баннеров
комманда: комманда
вниз: вниз
предварительно: предварительно
эталонный: эталонных
кристофер: Кристофер
преимущественно: преимущественно
страх: Страх
непредоставление: непредоставление
обозначать: обозначают
астрахань: Астрахань
неправильный: неправильные неправильный
определяться: определяются определяться определяется
неудача: неудачу неудачей
допускаться: допускается
трудоустройство: трудоустройством
обычай: обычаями
пиксель: пиксели
мойофис: МойОфис
зеленоград: Зеленоград
павлов: Павлова
дальтон: Дальтона дальтон
светлана: Светлана
юрлицо: юрлицо
намерение: намерение
удав: удав
ортогональность: Ортогональность
волшебный: волшебные
несмешной: несмешные
преподавать: преподаёт
богданов: Богданов
спрос: спрос
сименс: сименс
извинить: извините
непрерывность: непрерывность
различие: различие
бампер: бамперов
предел: пределы пределах предел
проводить: проводит проводят проводить
невыносимый: невыносимые
ссылаться: ссылаются
закрыться: закрылась
дарба: Дарбу
обезличивание: обезличивание
служебный: Служебные
москва: Москвы Москва Москве
уникально: уникально
помещение: помещение
конструктивный: конструктивной
входной: входных
накреативить: накреативили
предложный: предложен
потыкать: потыкать
виноградов: Виноградов
родиться: родился
треть: треть
школьный: школьных
разминать: Разминаем
тула: Тула
честь: честь
краснодар: Краснодар
грей: грей
наноматериал: Наноматериалы
прикладываться: прикладывается
федерация: Федерации
внезапно: Внезапно
преобразование: Преобразования Преобразование преобразования
куцовол: Куцовол
самозванец: самозванца
отлично: Отлично отлично
симметрично: симметрично
метеоролог: метеоролог
метасимвол: метасимволов
чистый: чистом
длиться: длится длились
сковырнуть: сковырнуть
ловить: ловить
просматривать: просматривает просматриваю просматриваем
понравиться: понравилось понравившуюся
коммитить: коммитить
фарада: фарад
регистрационный: Регистрационный
завершаться: завершается
чековый: чеков
инициализация: инициализация
подзадача: подзадачи
мужской: мужские
ангел: Ангел
сериализация: сериализацией
выгрузка: выгрузки выгрузке
совершенно: совершенно
серверный: Серверное
получатель: получатель
многопоточный: многопоточных Многопоточный
переименовывать: переименовываем
патчинга: патчинга
совершенный: совершенными
извлекаться: извлекается
писец: ПИСЕЦ
вскоре: Вскоре
заплатить: заплатить
никита: Никита
прохоров: Прохоров
творчество: творчества творчество
неизменяемый: Неизменяемый
апк: АПК
подружить: подружить
квантовый: квантовые квантовых
изобрести: изобрела изобрести
отслеживание: отслеживания
дискредитация: дискредитацию
уфа: Уфа
спрашивать: спрашивать
предполагаться: Предполагается
дебаг: дебагом
стрелять: стрелять
гражданский: Гражданского
перевешивать: перевешиваем
каверзный: каверзные
красота: Красота
контрольный: контрольном контрольные
экспоненциальный: Экспоненциальные экспоненциальный
стилтьеса: Стилтьеса
игнорировать: игнорируя игнорируют
осенний: Осенний
старое: старого
засчитать: засчитано
могилёв: Могилев
консалтинг: Консалтинг
синдром: синдром
учреждение: учреждений
советский: Советская
приспособленец: Приспособленец
разделиться: разделившаяся
стопка: стопку
отлавливать: отлавливаем
окончательно: окончательно
полочка: полочкам
выдать: выдаст выдать выданной
норвежский: норвежская
собираться: собираются
запросить: запросить запрошенное
фаззинга: фаззинга
гектар: гектар
отлов: отловом
основное: основном
пропуск: пропусков
пощупать: пощупать
глобальный: глобальная глобальных
бездействие: Бездействие
ручной: ручного Ручное ручному ручными
прояснять: проясняет
стыдный: стыдное
должность: должность
можно: Можно МОЖНО
создлаяться: создлаются
школьник: школьников
унификация: унификации
академия: Академия
открытие: Открытие
обходиться: обходится
исключительный: исключительных исключительные
необязательно: необязательно
визуализатор: визуализатор
среднее: среднем
непосредственный: непосредственного
познакомиться: познакомиться
развиваться: развивается развиваться
законность: законности
господряд: господряды
ущерб: ущерб ущерба
ардекс: Ардекс
вор: воры
смирнов: Смирнов
спланировать: спланировать
сумасшедший: сумасшедшего
ноль: ноль
дед: Дед Деда
выводиться: выводится
делаться: делается
журналистика: Журналистика
спутник: спутников
татьяна: Татьяна
составление: Составление составление
промптов: промптов
двухмерный: двухмерный
встраивание: встраивания
четверть: четверть
кровь: кровью
нравиться: нравится нравятся
брендирование: Брендирование
дарить: дарим
вред: вред
логинов: логинов
ес: ЕС
пусто: пусто
всадник: всадниками
увеличивать: увеличиваем увеличивает
несовершеннолетний: несовершеннолетних
чисто: чисто
датский: датская
монт: Монте
ландауэр: Ландауэра
исчерпывающий: исчерпывающую
обозначить: Обозначим
молодец: молодцы
объяснить: объяснили
вырастить: вырастить
скапливаться: скапливается
слушатель: Слушатель
уверенный: уверен
достать: достать
удачно: удачно
утилит: утилиту
резидент: резидентов
записаться: записались
курцвейль: Курцвейля
неочевидность: неочевидностей
привыкать: привыкаете
обеспечить: обеспечить
ом: ом
герой: героев
установщик: установщик
идентичный: идентичны
кодекс: кодекса Кодекс
запомниться: запомнилось
безумие: безумие
челленджа: челленджи
прикрутить: прикрутить
масштабирование: масштабирования
аутсорсинг: аутсорсинг
питомец: Питомцы
звёздочка: звездочкой
реализоваться: реализуется
маруся: Маруся
упорядоченность: упорядоченность
стартовать: Стартуем
нечто: нечто
регион: регионов
хевисайда: Хевисайд
приобрести: приобрести
наполнение: наполнением наполнения
квартира: квартирой
май: мая
олимпиадный: олимпиадная
регулятор: регулятором
генератор: Генератор
соотечественник: соотечественники
ежегодно: ежегодно
поощрение: поощрения
интегрирование: интегрирование
придавать: придавали
заглавный: Заглавная
приписка: припиской
грейд: грейд
увеличить: Увеличим
просвещение: Просвещение
занятый: занято
население: населения
резонанс: резонанс
откат: откат откатам
выражаться: выражается
заново: заново
устояться: Устоявшийся
безотлагательно: безотлагательно
обезвредить: обезвредить
рациональный: Рациональные
именовать: именовали
покрытие: покрытие
скрипт: скриптов скрипт
слинковать: слинковать
стандартно: стандартно
наладить: наладить
триггер: триггер
непривычный: непривычен
минск: Минск
дописывать: дописываю
раскрутка: Раскрутка
рассказ: Рассказ
сходиться: сходятся
ланита: ЛАНИТ
заблокировать: заблокировать
поднятие: Поднятие
басманный: Басманном
поташник: Поташников
кулешов: Кулешов
неверный: неверную неверные
местонахождение: местонахождения
новгород: Новгород
заявление: заявлению Заявление
разумный: разумные
подкаст: подкаст Подкаст
японский: японского
секретный: секретное
зелёный: зеленом зеленая
квалифицировать: квалифицированы
выбраться: выберется
шприц: шприца
линуксоид: линуксоида
аудитория: аудиторией
судебный: судебных
обусловить: обусловил
арбитражный: Арбитражном
грань: грани
ютека: Ютека
гайда: Гайд
взаимоотношение: взаимоотношениях
нежелательный: нежелательные
робокасса: робокассу
событие: событий событиях
лёд: льда
енама: енама
берет: берете
омск: Омск
представление: представления
буткемп: буткемп
интерпретатор: Интерпретатор
подготовиться: подготовиться
многопоточность: многопоточность Многопоточность
примерчик: примерчик
необходимость: необходимость
сферический: Сферический
неочевидный: Неочевидные
изменяться: изменяться
плодить: плодить
инсайт: инсайты
эротика: эротики
корейский: корейского
вода: воды вода воду водой
расшифровка: расшифровки
здоровье: здоровья
маятник: маятник
произвести: произведенному произвели
сдвинуть: сдвинуты
перформанс: перфомансом перформанс
гитхаб: гитхаб
зря: Зря
таргетинг: таргетинга
капуста: капуста
компилятор: Компилятор
изложение: изложением
выражать: выражаемая
бесконечность: бесконечности
словить: словили
заключительный: Заключительные
алабама: Алабамы
качаться: качалось
победитель: победителей
дискретный: дискретных
приближённый: приближённом
сотрудничество: сотрудничестве
воронеж: Воронеж
дельфин: дельфин
видеозвонок: Видеозвонки
постановление: Постановлением
игровой: игровому
српски: Српски
пассажирский: пассажирских
паника: панике
пятигорск: Пятигорск
баран: баранам
улучшать: улучшает
забивать: забивать
перевозка: перевозок
родственник: родственники
частность: частности
производительность: производительность производительности
полагать: полагать полагая
аналитически: аналитически
означать: означает
доверие: доверии доверия
стабильность: стабильность
военный: военного
мартин: Мартин
заканчивать: заканчивая
корреспондентский: корреспондентский
сужаться: сужается
метрика: Метрика метрику метрик
анонимный: анонимным
дима: Дима
простыня: простыню
расширяться: расширяться
взаймы: взаймы
вуз: вузов
синхронизация: Синхронизация
перенаправление: перенаправления
сойти: сойти
ограничиваться: ограничивается
модификатор: модификатором
косячать: косячу
голос: голосов
затравкин: Затравкин
расследование: расследование
безоговорочный: безоговорочное
лайна: лайн
выдаваться: выдается
вводный: вводные
сеньор: сеньору сеньор
ной: ноя
дума: Думу
демонстрация: демонстрация
впервые: впервые
приветствоваться: приветствуются
маркировка: маркировки
буфер: буфер
вариация: вариаций
опенсорсный: Опенсорсная
регламентировать: регламентирующие
профессионализм: профессионализма
неправославный: неправославную
куба: куба
отладочный: отладочный
поддомен: поддомены поддоменов
присоединиться: присоединившееся
разобрать: разобрано разобрать
ўзбекча: ўзбекча
мелкий: мелкие
экстремизм: экстремизм
дупликация: дупликация
выставлить: выставлить
лишить: лишена
пузырёк: пузырьком
упор: упора
сударь: сударь
комитет: комитета
седой: седых
повеять: повеяло
пушить: пушат
открыться: откроется
мара: мар
прослушиваться: прослушивается
ежедневно: Ежедневно
сброс: Сброс
кибербезопасность: кибербезопасность
изначально: Изначально изначально
перекрываться: перекрываются
абель: Абеля
штаб: штаб
тимлид: тимлидов
рекламодатель: Рекламодателей
занятость: занятость
страшно: страшно
убеждаться: убеждаюсь
мифический: мифических
химик: химик
затащить: затащить
явный: явные
уплатить: уплачено
сканирование: сканирование
тьюринг: Тьюринга
иногда: Иногда
молодой: моложе молодых
гарантированно: гарантированно
схемотехник: Схемотехник
искаться: ищется
уважаемый: Уважаемые
уникальность: уникальность
мтс: МТС
земля: Земли
кватернион: кватерниона
владислав: Владислав
аналогия: аналогии
пересечение: пересечения
показываться: показываться
прибыть: ПРИБУДЕТ
дональд: Дональд
липецк: Липецк
зацикливаниябнуть: зацикливанияб
виджет: виджет
вычислить: вычислить
двумерный: двумерному
оттачивать: оттачивать
подозревать: Подозреваю
предусматривать: предусматривают
линейность: Линейность
оживить: оживить
ежедневный: ежедневную
млн: млн
новичок: новичков новичкам новичка
крестик: крестиком
владимир: Владимир
дуда: дуде
разделять: разделяют разделяет
покрыть: покрыты
пропорционально: пропорционально
продешевить: продешевить
уступка: уступку
переделать: переделаем
суммирование: суммированием
планета: планеты
чей: чья
тестировщица: тестировщицы
повтор: повтора
минималка: минималках
набег: набегов
фатальный: фатального
полушарие: полушарие
заверить: заверенное
стартовый: стартового
критично: критично
ракурс: ракурсах
сделка: сделка сделки
перемножать: перемножать
противоречие: противоречие
докладчик: докладчика
пожаловать: пожаловать
коллаборативный: коллаборативный
вращение: вращения
хранитель: Хранитель
уже: Уже
перенять: перенять
люкс: люкс
трапеция: трапеций
отбор: отборе отбора
всероссийский: всероссийская
уходить: уходить
цуписа: цупису
рассчитывать: рассчитывать
подписывать: подписываем
шахматы: шахматы
юридически: юридически
вдвое: вдвое
продакт: Продакт
киевский: Киевская
вертикально: вертикально
руслан: Руслан
наблюдать: наблюдаем
никитин: Никитин
петрович: Петрович
видный: Виден
именование: именования
связываться: связывается
директолог: Директолог
плакать: Плакать
распознавать: распознавать
тонна: тонна
дисплей: дисплея
подсушить: Подсушить
заведение: заведений
толстой: толстая
устать: устали
рисование: Рисование
связанный: связанную
мультимодульный: мультимодульный
репортажный: Репортажная
построчно: построчно
копирование: копирования
календарь: Календарь календаре
осёл: осла
двойной: Двойное
разница: Разница
брокер: брокером
всплыть: всплыли
удаваться: удается
фокус: фокусом
апатия: Апатия
инвеллект: Инвеллект
сибур: СИБУР
илья: Илья
отчество: отчество
ненависть: ненависть
клавиша: клавиш
оптимизировать: оптимизировать
нет: Нет
дублирование: дублирование
резонно: резонно
вести: вести
храм: храм
наклон: наклона
безлимитный: безлимитная
кандела: кандела
попарно: попарно
топор: топора
трансформация: трансформации
усложнить: усложнить
лирический: Лирическое
джоуль: джоуль
новосибирск: Новосибирск
критика: критике
новочеркасск: Новочеркасск
спойлерить: спойлерить
дорожный: дорожных
счисление: счислений
считывать: считывает
ёлочка: ёлочка
перерабатывать: перерабатываем перерабатывать
убеждение: убеждений
корректность: корректность
задуматься: задуматься
том: томах
защищать: защищать
гамильтонов: гамильтоновом
белгород: Белгороде Белгород
бензопила: бензопила
хабрасленг: Хабрасленг
влиять: влияет
бит: битах
меллина: Меллина
ограничивать: ограничивающих
лицензировать: лицензировать
нейтральный: нейтральными
вперёд: вперед
профит: профит
доводиться: доводиться
умолчание: умолчанию
прямиком: прямиком
низкий: низкими
приставка: Приставки
гражданин: граждане
нападение: нападении
кольцово: Кольцово
варган: Варганов
жаров: Жаров
дивиденд: дивидендов
энтузиаст: Энтузиаст
поднять: поднять
завеса: завесу
компилироваться: компилироваться
выявление: выявления
коммуникатор: коммуникатор
неправый: неправ
псевдоевклидов: Псевдоевклидово
внутренность: внутренность
задеплоиться: задеплоится
нарушаться: нарушаются
сложить: сложить
ездить: ездили
снабдить: снабдить
панорама: панорамы
хром: хрома
яркость: Яркость
отделить: отделить
разбивать: разбивать
доработать: доработать доработали
перемещаться: перемещаются
технотекст: Технотекст
электромагнитный: электромагнитного
отлавливание: отлавливание
соотношение: соотношение
релевантность: релевантности
визуальный: визуальные
грант: грантов
превращать: превращает
калуга: Калуга
лекция: Лекция лекций
родственный: Родственные
образовывать: образовывали
српскохрватски: српскохрватски
госайтишник: Госайтишники
мираполис: Мираполис
предупреждать: предупреждая
минимально: минимально
роадмэп: Роадмэп
дивиться: дивился
классный: классная
волк: волк
промпт: промпте
букмекер: букмекеры
мотоциклист: мотоциклист
орбитальный: орбитальных
удаляться: удаляются
разбирать: разбираем
успеть: успели
справедливость: Справедливости справедливости
угадать: угадаешь
правда: правду
закрытие: Закрытие
круг: кругу круга
поздравлять: поздравляет
авторизация: авторизацию
возить: возят
забирать: забирает
налево: налево
городской: городских
край: краев
сбивать: сбивающими
круто: круто
соскочить: соскочить
нетривиальный: нетривиальное нетривиальном
тыкать: тыкать
прилагать: прилагает
унитарный: унитарных
нумерация: нумерация
обращаться: обращаться
бангкок: Бангкок
натыкаться: натыкаемся
инициал: инициалы
многий: многим
колонка: колонок
лендинга: лендингам
рекрутер: рекрутеров
ответственность: ответственность
вступительный: вступительные
иркутск: Иркутск
программизм: программизма
уверенность: уверенностью
хардкор: хардкор
пирамида: пирамид
достаточность: Достаточность
переварить: переваренном
пошутить: пошутить
спокойно: спокойно
наркотический: наркотических
заменяться: заменяется
обойти: обойти
только: Только
великолепие: великолепие
радость: радость
персистентность: персистентность
символьный: символьное
научить: научить
санитайзер: санитайзеры
назначить: назначенный
шеннон: Шеннона
хакнуть: хакнул
пересказать: пересказать
завтра: завтра
значимый: значимо
подставлять: подставляет
нежелание: нежелание
финальный: финальный
дубна: Дубна
бек: Бек
зимний: зимними
ворваться: ворвался
букмекерский: букмекерский
увольняться: Увольняться
чётный: четными чётных
ясно: Ясно
классика: классике
доставлять: доставляет
нелепо: нелепо
делегат: делегат
тревожный: Тревожно
дедлка: дедлок
тамтам: ТамТам
ковыряние: ковырянием
памятка: памятка
совпадение: совпадение
наслаждаться: наслаждаться
надёжно: надежно
скопипастила: скопипастил
сутки: сутки
судить: Судите судя
слышать: слышал
упорядочевание: упорядочевание
тройной: Тройная
ссср: СССР
трифонов: Трифонов
свободно: свободно
справиться: справятся
сопоставить: сопоставить
невозможность: невозможность
насилие: насилие
значительно: значительно
электромагнетизм: электромагнетизму
утрата: утраты
достигать: достигает
агент: агентов
казна: казну
кошелёк: Кошелёк
ведущий: Ведущая
бессель: Бесселя
приоткрыть: приоткрыть
платформенный: платформенный
последовательно: последовательно
эмулировать: эмулировать
оперативный: оперативной
йошкара: Йошкар
снять: снять
кнут: Кнута
предполагать: предполагаем
скорый: скором
уголовник: уголовников
железнодорожный: Железнодорожный
аниматор: аниматор
гибрид: Гибрид
филон: Филонов
настолько: настолько
документооборот: документооборота
подтверждать: подтверждает подтверждаете
пиратский: пиратское
рачича: Рачич
конкурентность: конкурентностью
возражение: возражения
постфикс: постфиксы
набить: набила
пополам: пополам
директория: директорий
достоверный: достоверную
налог: налог
грузить: грузить
доход: доход
статистический: Статистическая статистических
байткод: байткода
счёт: счет
деваться: деваться
лёгкость: легкостью
повстречаться: повстречается
кажущийся: кажущуюся
теперь: Теперь
радон: Радона
лихой: Лихие
аутентификация: аутентификация
смешно: смешно
поискать: поискать
временно: временно
пропаганда: пропагандой
решениять: решенияВ
экзотический: Экзотические
сингулярный: Сингулярное
многократный: многократном
строительство: строительстве
уральск: Уральск
елена: Елена
активно: активно
выправлять: выправлять
гораздо: гораздо
кириллица: кириллице
фактор: факторов
чётко: четко
подрядчик: подрядчика
результирующий: результирующем
оскарович: Оскарович
пиксельный: пиксельными
оптический: Оптическое
затрагивать: затрагивает
подлинность: подлинности
атом: атома
камерный: камерный
сложно: сложно
русь: Руси
единство: единства
троичный: Троичный
закончить: Закончили
активировать: активирует
ремонт: ремонт
самолёт: Самолет
